state,county,ctrump16,cclinton16,cotherpres16,cmedian_hh_inc,County Vote Total,ctrump16_pct,cdifference
Alabama,Autauga,18172,5936,865,53099.0,24973,0.7276658791494814,12236
Alabama,Baldwin,72883,18458,3874,51365.0,95215,0.765457123352413,54425
Alabama,Barbour,5454,4871,144,33956.0,10469,0.5209666634826631,583
Alabama,Bibb,6738,1874,207,39776.0,8819,0.7640322031976414,4864
Alabama,Blount,22859,2156,573,46212.0,25588,0.8933484445833985,20703
Alabama,Bullock,1140,3530,40,29335.0,4710,0.24203821656050956,-2390
Alabama,Butler,4901,3726,105,34315.0,8732,0.5612688960146587,1175
Alabama,Calhoun,32865,13242,1757,41954.0,47864,0.6866329600534848,19623
Alabama,Chambers,7843,5784,273,36027.0,13900,0.5642446043165468,2059
Alabama,Cherokee,8953,1547,233,38925.0,10733,0.8341563402590143,7406
Alabama,Chilton,15081,2911,377,42594.0,18369,0.8210027764167892,12170
Alabama,Choctaw,4106,3109,77,32622.0,7292,0.5630828304991772,997
Alabama,Clarke,7140,5749,142,32735.0,13031,0.5479241807996317,1391
Alabama,Clay,5245,1237,142,38815.0,6624,0.7918176328502415,4008
Alabama,Cleburne,5764,684,145,36316.0,6593,0.8742605794023964,5080
Alabama,Coffee,15875,4221,671,47872.0,20767,0.7644339577213849,11654
Alabama,Colbert,16746,7312,857,43786.0,24915,0.6721252257676099,9434
Alabama,Conecuh,3420,3080,85,27609.0,6585,0.5193621867881549,340
Alabama,Coosa,3381,1782,89,31910.0,5252,0.6437547600913938,1599
Alabama,Covington,13267,2387,286,37313.0,15940,0.8323086574654956,10880
Alabama,Crenshaw,4513,1664,90,37557.0,6267,0.720121270145205,2849
Alabama,Cullman,32989,3798,1086,39297.0,37873,0.8710426953238455,29191
Alabama,Dale,13808,4413,528,44093.0,18749,0.7364659448503921,9395
Alabama,Dallas,5789,12836,167,28136.0,18792,0.308056619838229,-7047
Alabama,DeKalb,21405,3622,799,38248.0,25826,0.8288159219391311,17783
Alabama,Elmore,27634,8443,1183,53398.0,37260,0.7416532474503489,19191
Alabama,Escambia,9935,4605,305,32334.0,14845,0.6692489053553385,5330
Alabama,Etowah,32353,10442,1369,40478.0,44164,0.7325649850557014,21911
Alabama,Fayette,6712,1362,175,36205.0,8249,0.813674384773912,5350
Alabama,Franklin,9466,2197,377,36138.0,12040,0.7862126245847176,7269
Alabama,Geneva,9994,1525,239,36519.0,11758,0.8499744854567103,8469
Alabama,Greene,838,4013,29,21339.0,4880,0.17172131147540984,-3175
Alabama,Hale,3173,4775,92,33351.0,8040,0.39465174129353237,-1602
Alabama,Henry,5632,2292,148,41045.0,8072,0.6977205153617443,3340
Alabama,Houston,30728,10664,1247,41945.0,42639,0.7206547995966134,20064
Alabama,Jackson,16672,3673,639,38422.0,20984,0.79451010293557,12999
Alabama,Jefferson,134768,156873,12550,47220.0,304191,0.4430374337176314,-22105
Alabama,Lamar,5823,1036,107,34298.0,6966,0.8359173126614987,4787
Alabama,Lauderdale,27899,9952,1674,43657.0,39525,0.7058570524984187,17947
Alabama,Lawrence,10833,3627,369,42339.0,14829,0.730528019421404,7206
Alabama,Lee,34617,21230,3344,45056.0,59191,0.5848355324289165,13387
Alabama,Limestone,29067,9468,1759,51115.0,40294,0.7213729091179828,19599
Alabama,Lowndes,1751,4883,50,27914.0,6684,0.26196888090963494,-3132
Alabama,Macon,1431,7566,143,32390.0,9140,0.15656455142231948,-6135
Alabama,Madison,89520,62822,11047,60150.0,163389,0.5478949011255347,26698
Alabama,Marengo,5233,5615,146,30713.0,10994,0.47598690194651627,-382
Alabama,Marion,11274,1432,278,34074.0,12984,0.8682994454713494,9842
Alabama,Marshall,29233,4917,1166,39831.0,35316,0.8277551251557368,24316
Alabama,Mobile,95116,72186,5435,44263.0,172737,0.5506405691889983,22930
Alabama,Monroe,5795,4332,144,28182.0,10271,0.564209911401032,1463
Alabama,Montgomery,34003,58916,2959,45358.0,95878,0.35464861594943575,-24913
Alabama,Morgan,37486,11254,1904,46883.0,50644,0.7401863991785799,26232
Alabama,Perry,1407,3824,47,24912.0,5278,0.26657824933687,-2417
Alabama,Pickens,5456,3972,114,31679.0,9542,0.5717878851393837,1484
Alabama,Pike,7693,5056,419,33193.0,13168,0.5842193195625759,2637
Alabama,Randolph,7705,2291,191,37496.0,10187,0.756356140178659,5414
Alabama,Russell,9210,9579,467,38400.0,19256,0.47829248026589116,-369
Alabama,St. Clair,31651,5589,1160,54042.0,38400,0.8242447916666666,26062
Alabama,Shelby,73020,22977,5257,72310.0,101254,0.7211566950441464,50043
Alabama,Sumter,1581,4746,84,20428.0,6411,0.2466073935423491,-3165
Alabama,Talladega,20614,12121,672,37923.0,33407,0.617056305564702,8493
Alabama,Tallapoosa,13594,5519,373,39395.0,19486,0.6976290670224776,8075
Alabama,Tuscaloosa,47723,31762,3215,48022.0,82700,0.577061668681983,15961
Alabama,Walker,24266,4497,709,37025.0,29472,0.82335776330076,19769
Alabama,Washington,6042,2374,117,40293.0,8533,0.7080745341614907,3668
Alabama,Wilcox,1737,4339,42,24442.0,6118,0.28391631252043154,-2602
Alabama,Winston,9228,872,213,33896.0,10313,0.8947929797343159,8356
Arizona,Apache,8240,17083,2338,32460.0,27661,0.2978923393948158,-8843
Arizona,Cochise,28092,17450,4473,45383.0,50015,0.5616714985504349,10642
Arizona,Coconino,21108,32404,6272,51106.0,59784,0.35307105580088316,-11296
Arizona,Gila,14182,7003,15512,40593.0,36697,0.3864621086192332,7179
Arizona,Graham,8025,3301,8980,47422.0,20306,0.39520338816113465,4724
Arizona,Greenlee,1892,1092,2208,51813.0,5192,0.3644067796610169,800
Arizona,La Paz,4003,1575,373,36321.0,5951,0.6726600571332549,2428
Arizona,Maricopa,747361,702907,117566,55676.0,1567834,0.4766837560609095,44454
Arizona,Mohave,58282,17455,4206,39856.0,79943,0.7290444441664686,40827
Arizona,Navajo,20577,16459,3258,36868.0,40294,0.5106715640045665,4118
Arizona,Pima,167428,224661,29551,46764.0,421640,0.3970875628498245,-57233
Arizona,Pinal,72819,47892,8835,51190.0,129546,0.5621092121717383,24927
Arizona,Santa Cruz,3897,11690,846,38941.0,16433,0.2371447696707844,-7793
Arizona,Yavapai,71330,35590,7530,46638.0,114450,0.6232415902140673,35740
Arizona,Yuma,25165,24605,3240,41467.0,53010,0.47472175061309185,560
Arkansas,Arkansas,3826,1939,447,37330.0,6212,0.6159047005795235,1887
Arkansas,Ashley,5338,2408,337,36352.0,8083,0.6603983669429667,2930
Arkansas,Baxter,14682,4169,915,38115.0,19766,0.7427906506121623,10513
Arkansas,Benton,60871,28005,7948,59016.0,96824,0.628676774353466,32866
Arkansas,Boone,12235,2926,950,38664.0,16111,0.7594190304760723,9309
Arkansas,Bradley,2164,1317,172,34665.0,3653,0.5923898165891048,847
Arkansas,Calhoun,1556,639,74,35446.0,2269,0.6857646540326134,917
Arkansas,Carroll,6786,3342,630,38145.0,10758,0.6307863915225879,3444
Arkansas,Chicot,1716,2350,110,29628.0,4176,0.4109195402298851,-634
Arkansas,Clark,4404,3620,502,35595.0,8526,0.5165376495425756,784
Arkansas,Clay,3781,1199,220,32404.0,5200,0.7271153846153846,2582
Arkansas,Cleburne,9458,2101,526,41717.0,12085,0.7826230864708316,7357
Arkansas,Cleveland,2462,723,169,42429.0,3354,0.7340488968395945,1739
Arkansas,Columbia,5456,3140,291,36507.0,8887,0.6139304602227973,2316
Arkansas,Conway,4849,2656,422,38266.0,7927,0.6117068247760817,2193
Arkansas,Craighead,22892,10538,2143,43892.0,35573,0.6435217721305484,12354
Arkansas,Crawford,16686,4488,1276,41792.0,22450,0.7432516703786192,12198
Arkansas,Crittenden,6964,8410,578,39407.0,15952,0.43655967903711135,-1446
Arkansas,Cross,4584,1999,291,39306.0,6874,0.6668606342740763,2585
Arkansas,Dallas,1509,1165,97,35745.0,2771,0.5445687477444966,344
Arkansas,Desha,1919,2228,110,26519.0,4257,0.4507869391590322,-309
Arkansas,Drew,3968,2365,262,33092.0,6595,0.6016679302501895,1603
Arkansas,Faulkner,29346,14629,3552,50872.0,47527,0.617459549308814,14717
Arkansas,Franklin,5039,1376,355,39482.0,6770,0.7443131462333825,3663
Arkansas,Fulton,3471,1067,234,35593.0,4772,0.7273679798826488,2404
Arkansas,Garland,26087,12311,2407,40011.0,40805,0.6393089082220316,13776
Arkansas,Grant,5725,1373,347,49195.0,7445,0.7689724647414372,4352
Arkansas,Greene,10720,3071,809,42755.0,14600,0.7342465753424657,7649
Arkansas,Hempstead,4401,2377,271,34072.0,7049,0.6243438785643354,2024
Arkansas,Hot Spring,8172,3149,623,42589.0,11944,0.6841929002009377,5023
Arkansas,Howard,3157,1351,166,34672.0,4674,0.6754385964912281,1806
Arkansas,Independence,9936,2881,797,37592.0,13614,0.7298369325694138,7055
Arkansas,Izard,4042,1113,293,35188.0,5448,0.7419236417033774,2929
Arkansas,Jackson,3267,1583,306,31245.0,5156,0.6336307214895268,1684
Arkansas,Jefferson,9250,15772,872,36377.0,25894,0.35722561211091375,-6522
Arkansas,Johnson,6091,2427,594,34031.0,9112,0.668459174714662,3664
Arkansas,Lafayette,1758,1032,70,29882.0,2860,0.6146853146853147,726
Arkansas,Lawrence,4064,1263,358,33381.0,5685,0.7148636763412489,2801
Arkansas,Lee,1229,1735,62,25724.0,3026,0.4061467283542631,-506
Arkansas,Lincoln,2455,1252,119,32369.0,3826,0.641662310507057,1203
Arkansas,Little River,3605,1397,225,35396.0,5227,0.6896881576430075,2208
Arkansas,Logan,5746,1715,460,36463.0,7921,0.7254134578967302,4031
Arkansas,Lonoke,19958,5664,1478,56156.0,27100,0.7364575645756457,14294
Arkansas,Madison,4928,1588,325,39839.0,6841,0.7203625200994007,3340
Arkansas,Marion,5336,1434,337,33726.0,7107,0.7508090614886731,3902
Arkansas,Miller,11294,4273,524,39955.0,16091,0.7018830402088124,7021
Arkansas,Mississippi,7061,5670,473,35003.0,13204,0.5347621932747653,1391
Arkansas,Monroe,1489,1312,83,31541.0,2884,0.5162968099861304,177
Arkansas,Montgomery,2643,748,168,35103.0,3559,0.7426243326777184,1895
Arkansas,Nevada,2000,1157,89,30750.0,3246,0.6161429451632778,843
Arkansas,Newton,2875,699,179,33176.0,3753,0.7660538236077804,2176
Arkansas,Ouachita,5351,4321,263,31233.0,9935,0.5386009058882738,1030
Arkansas,Perry,3008,1049,249,45819.0,4306,0.6985601486298189,1959
Arkansas,Phillips,2446,4310,197,26829.0,6953,0.35179059398820656,-1864
Arkansas,Pike,3150,685,146,34519.0,3981,0.7912584777694047,2465
Arkansas,Poinsett,5502,1880,340,35163.0,7722,0.7125097125097125,3622
Arkansas,Polk,6618,1212,401,33202.0,8231,0.8040335317701373,5406
Arkansas,Pope,16256,5000,1313,40534.0,22569,0.7202800301298241,11256
Arkansas,Prairie,2505,814,125,37500.0,3444,0.7273519163763066,1691
Arkansas,Pulaski,61257,89574,8945,47101.0,159776,0.3833930002002804,-28317
Arkansas,Randolph,4509,1425,445,36318.0,6379,0.7068506035428751,3084
Arkansas,St. Francis,3195,4031,204,35066.0,7430,0.4300134589502019,-836
Arkansas,Saline,35863,13256,2981,57632.0,52100,0.6883493282149712,22607
Arkansas,Scott,2731,602,177,37861.0,3510,0.778062678062678,2129
Arkansas,Searcy,2955,601,172,35542.0,3728,0.7926502145922747,2354
Arkansas,Sebastian,29127,12300,3210,40023.0,44637,0.6525304119900531,16827
Arkansas,Sevier,3282,1075,205,38956.0,4562,0.7194213064445418,2207
Arkansas,Sharp,5407,1472,370,31068.0,7249,0.7458959856531936,3935
Arkansas,Stone,4113,1203,302,30486.0,5618,0.7321110715557138,2910
Arkansas,Union,10456,5855,583,39836.0,16894,0.6189179590387119,4601
Arkansas,Van Buren,5382,1549,408,34576.0,7339,0.7333424172230549,3833
Arkansas,Washington,41476,33366,7019,45442.0,81861,0.5066637348676415,8110
Arkansas,White,21077,5170,972,42197.0,27219,0.7743488004702598,15907
Arkansas,Woodruff,1347,1118,106,30383.0,2571,0.5239206534422404,229
Arkansas,Yell,4608,1480,351,39323.0,6439,0.7156390743904333,3128
California,Alameda,95922,514842,43502,79831.0,654266,0.14661009436528874,-418920
California,Alpine,217,334,51,62375.0,602,0.36046511627906974,-117
California,Amador,10485,6004,1245,57032.0,17734,0.5912371715349047,4481
California,Butte,45144,41567,8853,44366.0,95564,0.47239546272654975,3577
California,Calaveras,13511,7944,1681,53502.0,23136,0.583981673582296,5567
California,Colusa,3551,2661,420,54946.0,6632,0.5354342581423401,890
California,Contra Costa,115956,319287,30932,82881.0,466175,0.24873920737920308,-203331
California,Del Norte,5134,3485,939,42363.0,9558,0.5371416614354467,1649
California,El Dorado,49247,36404,7940,72586.0,93591,0.5261937579468111,12843
California,Fresno,124049,141341,16929,45963.0,282319,0.43939302703679173,-17292
California,Glenn,5788,3065,617,41699.0,9470,0.6111932418162619,2723
California,Humboldt,18373,33200,7673,42685.0,59246,0.3101137629544611,-14827
California,Imperial,12704,32667,2720,42560.0,48091,0.26416585223846456,-19963
California,Inyo,4248,3155,683,47278.0,8086,0.5253524610437794,1093
California,Kern,129584,98689,15890,49788.0,244163,0.530727423893055,30895
California,Kings,18093,13617,2205,47241.0,33915,0.5334807607253428,4476
California,Lake,10599,11496,2401,36132.0,24496,0.4326828870019595,-897
California,Lassen,7574,2224,726,51457.0,10524,0.7196883314329152,5350
California,Los Angeles,769743,2464364,200201,57952.0,3434308,0.22413336252892868,-1694621
California,Madera,23357,17029,2726,45742.0,43112,0.5417749118574875,6328
California,Marin,21771,108707,8795,100310.0,139273,0.15631888449304604,-86936
California,Mariposa,5185,3122,570,49265.0,8877,0.5840937253576659,2063
California,Mendocino,10888,22079,4510,43510.0,37477,0.29052485524455,-11191
California,Merced,28725,37317,4747,44397.0,70789,0.4057833844241337,-8592
California,Modoc,2696,877,215,41194.0,3788,0.7117212249208026,1819
California,Mono,2111,2773,392,58937.0,5276,0.4001137225170584,-662
California,Monterey,34895,89088,9425,60889.0,133408,0.2615660230271048,-54193
California,Napa,17411,39199,4762,74609.0,61372,0.28369614808055793,-21788
California,Nevada,23365,26053,5517,57429.0,54935,0.4253208337125694,-2688
California,Orange,507148,609961,80412,78145.0,1197521,0.4234982100522663,-102813
California,Placer,95138,73509,14192,76926.0,182839,0.5203375647427518,21629
California,Plumas,5420,3459,797,50125.0,9676,0.5601488218272013,1961
California,Riverside,333243,373695,44453,57972.0,751391,0.4435014526391719,-40452
California,Sacramento,189789,326023,43518,57509.0,559330,0.3393148946060465,-136234
California,San Benito,7841,12521,1562,73814.0,21924,0.3576445904032111,-4680
California,San Bernardino,271240,340833,41910,54469.0,653983,0.4147508421472729,-69593
California,San Diego,477766,735476,93158,66529.0,1306400,0.3657118799755052,-257710
California,San Francisco,37688,345084,23020,87701.0,405792,0.09287516757353521,-307396
California,San Joaquin,88936,121124,14106,55045.0,224166,0.39674170034706424,-32188
California,San Luis Obispo,56164,67107,11738,64014.0,135009,0.416001896169885,-10943
California,San Mateo,57929,237882,18573,98546.0,314384,0.1842619217262965,-179953
California,Santa Barbara,56365,107142,13279,65161.0,176786,0.3188318079485932,-50777
California,Santa Clara,144826,511684,47199,101173.0,703709,0.20580381947651658,-366858
California,Santa Cruz,22438,95249,11134,70088.0,128821,0.17417967567399725,-72811
California,Shasta,51778,22301,5974,45582.0,80053,0.6467964973205251,29477
California,Sierra,1048,601,181,43984.0,1830,0.5726775956284152,447
California,Siskiyou,11341,7234,1917,38524.0,20492,0.5534354870193247,4107
California,Solano,51920,102360,11833,69227.0,166113,0.31255831873483714,-50440
California,Sonoma,51408,160435,19410,66833.0,231253,0.22230198094727419,-109027
California,Stanislaus,78494,81647,12005,51591.0,172146,0.455973417912702,-3153
California,Sutter,18176,13076,2271,52943.0,33523,0.5421949109566566,5100
California,Tehama,15494,6809,1605,40687.0,23908,0.6480675924376778,8685
California,Trinity,2812,2214,660,35270.0,5686,0.4945480126626803,598
California,Tulare,58299,47585,6450,42789.0,112334,0.5189791158509445,10714
California,Tuolumne,14551,9123,1855,50731.0,25529,0.5699792392964863,5428
California,Ventura,132323,194402,25001,78593.0,351726,0.3762104592779607,-62079
California,Yolo,20739,54752,6599,57663.0,82090,0.25263734925082226,-34013
California,Yuba,13170,7910,1918,48739.0,22998,0.5726584920427863,5260
Colorado,Adams,80082,96558,17025,61444.0,193665,0.41350786151343816,-16476
Colorado,Alamosa,3046,3189,704,32385.0,6939,0.4389681510304078,-143
Colorado,Arapahoe,117053,159885,26108,66288.0,303046,0.3862548919965946,-42832
Colorado,Archuleta,4264,2500,575,45607.0,7339,0.5810055865921788,1764
Colorado,Baca,1753,283,117,37477.0,2153,0.8142127264282397,1470
Colorado,Bent,1188,590,149,34773.0,1927,0.6165023352361183,598
Colorado,Boulder,41396,132334,14412,72282.0,188142,0.220025300039332,-90938
Colorado,Broomfield,14367,19731,3591,83334.0,37689,0.3811987582583778,-5364
Colorado,Chaffee,5391,4888,971,50993.0,11250,0.4792,503
Colorado,Cheyenne,925,132,45,54375.0,1102,0.8393829401088929,793
Colorado,Clear Creek,2575,2729,562,68250.0,5866,0.4389703375383566,-154
Colorado,Conejos,1914,1771,337,34630.0,4022,0.47588264545002484,143
Colorado,Costilla,588,1125,135,26610.0,1848,0.3181818181818182,-537
Colorado,Crowley,1079,339,109,31719.0,1527,0.7066142763588736,740
Colorado,Custer,2061,797,208,38605.0,3066,0.6722113502935421,1264
Colorado,Delta,11655,4087,1048,42011.0,16790,0.6941631923764146,7568
Colorado,Denver,62690,244551,24611,56258.0,331852,0.1889095138796813,-181861
Colorado,Dolores,944,242,69,32240.0,1255,0.7521912350597609,702
Colorado,Douglas,102573,68657,16269,105759.0,187499,0.5470589176475608,33916
Colorado,Eagle,8990,14099,2134,78763.0,25223,0.35642072711414186,-5109
Colorado,Elbert,11705,3134,1139,87288.0,15978,0.7325697834522469,8571
Colorado,El Paso,179228,108010,31729,60219.0,318967,0.5619013879178724,71218
Colorado,Fremont,15122,5297,1554,42308.0,21973,0.6882082555864015,9825
Colorado,Garfield,13132,11271,2067,61300.0,26470,0.4961088024178315,1861
Colorado,Gilpin,1566,1634,376,67544.0,3576,0.43791946308724833,-68
Colorado,Grand,4494,3358,736,67623.0,8588,0.5232883092687471,1136
Colorado,Gunnison,3289,5128,995,50746.0,9412,0.3494475138121547,-1839
Colorado,Hinsdale,339,197,53,51250.0,589,0.5755517826825127,142
Colorado,Huerfano,1883,1633,267,33257.0,3783,0.4977531060005287,250
Colorado,Jackson,629,171,61,45053.0,861,0.7305458768873403,458
Colorado,Jefferson,138177,160776,29929,72017.0,328882,0.4201415705328963,-22599
Colorado,Kiowa,728,91,36,38385.0,855,0.8514619883040936,637
Colorado,Kit Carson,2967,536,199,44449.0,3702,0.8014586709886548,2431
Colorado,Lake,1270,1616,313,46928.0,3199,0.39699906220693965,-346
Colorado,La Plata,12587,15525,3038,61910.0,31150,0.40407704654895665,-2938
Colorado,Larimer,83430,93113,19437,61942.0,195980,0.4257067047657924,-9683
Colorado,Las Animas,3710,2650,433,42808.0,6793,0.546150448991609,1060
Colorado,Lincoln,1892,409,135,40438.0,2436,0.7766830870279147,1483
Colorado,Logan,7282,1851,589,43340.0,9722,0.7490228348076527,5431
Colorado,Mesa,49779,21729,6145,50070.0,77653,0.6410441322292764,28050
Colorado,Mineral,344,237,71,49125.0,652,0.5276073619631901,107
Colorado,Moffat,5305,874,346,53664.0,6525,0.8130268199233717,4431
Colorado,Montezuma,7853,3973,1032,41622.0,12858,0.610748172344066,3880
Colorado,Montrose,14382,5466,1338,43890.0,21186,0.6788445199660152,8916
Colorado,Morgan,8145,3151,664,49495.0,11960,0.6810200668896321,4994
Colorado,Otero,4928,2943,581,34477.0,8452,0.5830572645527686,1985
Colorado,Ouray,1351,1697,262,62800.0,3310,0.4081570996978852,-346
Colorado,Park,6135,3421,861,61675.0,10417,0.5889411538830758,2714
Colorado,Phillips,1791,436,105,46955.0,2332,0.7680102915951973,1355
Colorado,Pitkin,2550,7333,640,69789.0,10523,0.24232633279483037,-4783
Colorado,Prowers,3531,1186,299,41037.0,5016,0.7039473684210527,2345
Colorado,Pueblo,36265,35875,6506,42000.0,78646,0.46111690359331686,390
Colorado,Rio Blanco,2791,436,223,56771.0,3450,0.8089855072463769,2355
Colorado,Rio Grande,3085,2001,448,40177.0,5534,0.5574629562703288,1084
Colorado,Routt,5230,7600,1156,63505.0,13986,0.37394537394537397,-2370
Colorado,Saguache,1147,1417,271,32457.0,2835,0.40458553791887125,-270
Colorado,San Juan,215,265,26,41250.0,506,0.424901185770751,-50
Colorado,San Miguel,1033,2975,321,58170.0,4329,0.23862323862323861,-1942
Colorado,Sedgwick,1015,267,82,46977.0,1364,0.7441348973607038,748
Colorado,Summit,5100,9557,1517,70192.0,16174,0.31532088537158404,-4457
Colorado,Teller,9745,3603,1096,63723.0,14444,0.674674605372473,6142
Colorado,Washington,2299,296,138,46315.0,2733,0.8412001463593121,2003
Colorado,Weld,76651,46519,12258,62820.0,135428,0.5659907847712438,30132
Colorado,Yuma,3850,726,215,42026.0,4791,0.8035900647046545,3124
Connecticut,Fairfield,160077,243852,17280,86670.0,421209,0.38004173699992166,-83775
Connecticut,Hartford,148173,240403,18288,68027.0,406864,0.36418311770026346,-92230
Connecticut,Litchfield,53051,39775,4616,73519.0,97442,0.5444366905441186,13276
Connecticut,Middlesex,38867,45357,4400,79837.0,88624,0.4385606607690919,-6490
Connecticut,New Haven,159048,205609,14349,62715.0,379006,0.4196450715819802,-46561
Connecticut,New London,54058,62278,7192,67574.0,123528,0.4376173822938929,-8220
Connecticut,Tolland,34194,38506,4724,80129.0,77424,0.4416460012399256,-4312
Connecticut,Windham,25747,21792,3284,60689.0,50823,0.5066013419121264,3955
Delaware,Kent,36991,33351,4256,55184.0,74598,0.49587120298131315,3640
Delaware,New Castle,85525,162919,13947,66283.0,262391,0.3259448685358873,-77394
Delaware,Sussex,62611,39333,4064,54218.0,106008,0.590625235831258,23278
District of Columbia,District of Columbia,12723,282830,15715,72935.0,311268,0.040874744593083774,-270107
Florida,Alachua,46834,75820,5917,44702.0,128571,0.3642656586633067,-28986
Florida,Baker,10294,2112,228,53327.0,12634,0.8147854994459395,8182
Florida,Bay,62194,21797,3462,48577.0,87453,0.711170571621328,40397
Florida,Bradford,8913,2924,261,43373.0,12098,0.7367333443544387,5989
Florida,Brevard,181848,119679,13225,49914.0,314752,0.5777501016673444,62169
Florida,Broward,260951,553320,17680,52954.0,831951,0.31366150169901835,-292369
Florida,Calhoun,4655,1241,185,37089.0,6081,0.7654990955434962,3414
Florida,Charlotte,60218,33445,2711,44865.0,96374,0.624836574179758,26773
Florida,Citrus,54456,22789,2455,39054.0,79700,0.6832622333751568,31667
Florida,Clay,74963,27822,3698,59179.0,106483,0.703990308312125,47141
Florida,Collier,105423,61085,4281,59783.0,170789,0.6172704331075186,44338
Florida,Columbia,20368,7601,738,42848.0,28707,0.7095133591110182,12767
Florida,Desoto,6778,3781,259,35513.0,10818,0.626548345350342,2997
Florida,Dixie,5822,1270,110,34634.0,7202,0.8083865592890863,4552
Florida,Duval,211672,205704,15319,49196.0,432695,0.4891944672344261,5968
Florida,Escambia,88808,57461,6200,46117.0,152469,0.5824659438967922,31347
Florida,Flagler,33850,22026,1627,48898.0,57503,0.5886649392205624,11824
Florida,Franklin,4125,1744,146,40301.0,6015,0.685785536159601,2381
Florida,Gadsden,6728,15020,365,38533.0,22113,0.3042554153665265,-8292
Florida,Gilchrist,6740,1458,222,40881.0,8420,0.8004750593824228,5282
Florida,Glades,2996,1271,86,34143.0,4353,0.6882609694463588,1725
Florida,Gulf,5329,1720,244,40822.0,7293,0.7307006718771425,3609
Florida,Hamilton,3443,1904,113,38980.0,5460,0.6305860805860806,1539
Florida,Hardee,5242,2149,192,36222.0,7583,0.6912831333245417,3093
Florida,Hendry,6195,4615,305,37552.0,11115,0.5573549257759784,1580
Florida,Hernando,58970,31795,3031,42274.0,93796,0.6287048488208452,27175
Florida,Highlands,29565,14937,1184,35865.0,45686,0.6471347896510966,14628
Florida,Hillsborough,266870,307896,22894,51681.0,597660,0.44652477997523676,-41026
Florida,Holmes,7483,853,178,37437.0,8514,0.8789053323937045,6630
Florida,Indian River,48620,29043,2346,47446.0,80009,0.6076816358159707,19577
Florida,Jackson,14257,6397,387,35470.0,21041,0.6775818639798489,7860
Florida,Jefferson,3930,3541,174,41696.0,7645,0.514061478090255,389
Florida,Lafayette,2809,518,65,36236.0,3392,0.828125,2291
Florida,Lake,102188,62838,5436,47141.0,170462,0.5994767162182774,39350
Florida,Lee,191551,124908,9961,50390.0,326420,0.5868237240365174,66643
Florida,Leon,53821,92068,6243,48248.0,152132,0.353778297794021,-38247
Florida,Levy,13775,5101,519,35480.0,19395,0.7102345965455015,8674
Florida,Liberty,2543,651,102,37917.0,3296,0.7715412621359223,1892
Florida,Madison,4851,3526,128,29806.0,8505,0.5703703703703704,1325
Florida,Manatee,101944,71224,5790,51483.0,178958,0.5696532147207725,30720
Florida,Marion,107833,62041,4826,40295.0,174700,0.6172467086433887,45792
Florida,Martin,53204,30185,2403,52622.0,85792,0.6201510630361805,23019
Florida,Miami-Dade,333999,624146,22059,44224.0,980204,0.3407443756605768,-290147
Florida,Monroe,21904,18971,1603,60303.0,42478,0.5156551626724422,2933
Florida,Nassau,34266,10869,1472,59196.0,46607,0.7352114489239814,23397
Florida,Okaloosa,71893,23780,5182,57655.0,100855,0.7128352585394874,48113
Florida,Okeechobee,9356,3959,338,36415.0,13653,0.6852706364901486,5397
Florida,Orange,195216,329894,21165,49391.0,546275,0.3573584732964166,-134678
Florida,Osceola,50301,85458,4447,45536.0,140206,0.3587649601300943,-35157
Florida,Palm Beach,272402,374673,15257,55277.0,662332,0.4112771238593334,-102271
Florida,Pasco,142101,90142,8896,46010.0,241139,0.5892908239646013,51959
Florida,Pinellas,239201,233701,19501,47090.0,492403,0.48578298669991854,5500
Florida,Polk,157430,117433,9451,44146.0,284314,0.5537187757198028,39997
Florida,Putnam,22138,10094,885,33003.0,33117,0.6684784249781079,12044
Florida,St. Johns,88684,43099,4731,69523.0,136514,0.6496330046735134,45585
Florida,St. Lucie,70289,66881,3677,44140.0,140847,0.49904506308263574,3408
Florida,Santa Rosa,65339,18464,3942,60652.0,87745,0.7446464185993504,46875
Florida,Sarasota,124438,97870,6755,52796.0,229063,0.5432479274260793,26568
Florida,Seminole,109443,105914,9539,58538.0,224896,0.48663826835515084,3529
Florida,Sumter,52730,22638,1297,52594.0,76665,0.6877975608165395,30092
Florida,Suwannee,14287,3964,443,37796.0,18694,0.7642559109874826,10323
Florida,Taylor,6930,2152,208,36195.0,9290,0.7459634015069968,4778
Florida,Union,4568,1014,112,37778.0,5694,0.8022479803301721,3554
Florida,Volusia,143007,109091,8771,42240.0,260869,0.5481946877551568,33916
Florida,Wakulla,10512,4348,491,54078.0,15351,0.6847762360758257,6164
Florida,Walton,25756,6876,1005,46910.0,33637,0.7657044326188424,18880
Florida,Washington,8637,2264,255,38330.0,11156,0.7742022230190032,6373
Georgia,Appling,5494,1434,84,37388.0,7012,0.7835139760410724,4060
Georgia,Atkinson,1878,697,35,31296.0,2610,0.7195402298850575,1181
Georgia,Bacon,3364,608,48,37303.0,4020,0.83681592039801,2756
Georgia,Baker,775,650,15,45903.0,1440,0.5381944444444444,125
Georgia,Baldwin,7697,7970,449,34595.0,16116,0.4775999007197816,-273
Georgia,Banks,6134,684,157,40721.0,6975,0.879426523297491,5450
Georgia,Barrow,21108,6580,1372,53133.0,29060,0.7263592567102547,14528
Georgia,Bartow,29911,8212,1427,50565.0,39550,0.756283185840708,21699
Georgia,Ben Hill,3739,2101,96,29510.0,5936,0.6298854447439353,1638
Georgia,Berrien,5422,1047,121,35740.0,6590,0.8227617602427921,4375
Georgia,Bibb,24043,36787,1766,37108.0,62596,0.38409802543293503,-12744
Georgia,Bleckley,3719,1101,154,37060.0,4974,0.7476879774829112,2618
Georgia,Brantley,5567,619,115,36837.0,6301,0.8835105538803365,4948
Georgia,Brooks,3701,2528,107,34547.0,6336,0.5841224747474747,1173
Georgia,Bryan,10529,4014,630,65862.0,15173,0.6939300072497199,6515
Georgia,Bulloch,15097,9261,958,37125.0,25316,0.5963422341602149,5836
Georgia,Burke,4491,4731,129,34589.0,9351,0.480269489894129,-240
Georgia,Butts,6717,2566,231,40753.0,9514,0.7060121925583351,4151
Georgia,Calhoun,830,1179,16,28200.0,2025,0.40987654320987654,-349
Georgia,Camden,12310,5930,661,53327.0,18901,0.6512882916247817,6380
Georgia,Candler,2664,1026,73,33379.0,3763,0.7079457879351582,1638
Georgia,Carroll,30029,12464,1628,45486.0,44121,0.680605607307178,17565
Georgia,Catoosa,20876,4771,1110,52265.0,26757,0.7802070486227903,16105
Georgia,Charlton,2951,1004,61,43871.0,4016,0.7348107569721115,1947
Georgia,Chatham,45688,62290,4164,49596.0,112142,0.40741203117476055,-16602
Georgia,Chattahoochee,751,594,45,43929.0,1390,0.5402877697841727,157
Georgia,Chattooga,6462,1613,177,35245.0,8252,0.7830828889966068,4849
Georgia,Cherokee,80649,25231,6163,72586.0,112043,0.719804003819962,55418
Georgia,Clarke,12717,29603,2656,33116.0,44976,0.2827508004268943,-16886
Georgia,Clay,566,697,10,22120.0,1273,0.44461901021209743,-131
Georgia,Clayton,12645,78220,1994,42470.0,92859,0.13617419959293123,-65575
Georgia,Clinch,1727,686,42,24848.0,2455,0.7034623217922606,1041
Georgia,Cobb,152912,160121,17786,68818.0,330819,0.4622225446543276,-7209
Georgia,Coffee,9588,4094,233,34536.0,13915,0.6890406036651096,5494
Georgia,Colquitt,9898,3463,263,33968.0,13624,0.7265120375807399,6435
Georgia,Columbia,43085,18887,2771,71962.0,64743,0.665477348902584,24198
Georgia,Cook,4176,1753,128,35199.0,6057,0.6894502228826151,2423
Georgia,Coweta,42533,16583,2629,65244.0,61745,0.6888492995384241,25950
Georgia,Crawford,3635,1421,120,40459.0,5176,0.7022797527047914,2214
Georgia,Crisp,4549,2837,126,31672.0,7512,0.6055644302449414,1712
Georgia,Dade,5051,965,226,43463.0,6242,0.8091957705863505,4086
Georgia,Dawson,9900,1448,417,59265.0,11765,0.8414789630259244,8452
Georgia,Decatur,6020,4124,142,33514.0,10286,0.585261520513319,1896
Georgia,DeKalb,51468,251370,11919,52623.0,314757,0.16351661758118166,-199902
Georgia,Dodge,5021,1839,149,35544.0,7009,0.7163646739905836,3182
Georgia,Dooly,1951,1872,36,33319.0,3859,0.5055713915522156,79
Georgia,Dougherty,10232,23311,544,33605.0,34087,0.3001730865139203,-13079
Georgia,Douglas,24817,31005,1916,57384.0,57738,0.4298209151685199,-6188
Georgia,Early,2552,2168,65,28599.0,4785,0.5333333333333333,384
Georgia,Echols,1007,156,19,35354.0,1182,0.8519458544839256,851
Georgia,Effingham,17874,4853,731,62820.0,23458,0.7619575411373518,13021
Georgia,Elbert,5292,2539,156,35739.0,7987,0.6625766871165644,2753
Georgia,Emanuel,5335,2435,90,31522.0,7860,0.6787531806615776,2900
Georgia,Evans,2404,1130,79,40594.0,3613,0.6653750345972875,1274
Georgia,Fannin,9632,1923,257,39011.0,11812,0.81544192346766,7709
Georgia,Fayette,35048,23284,2581,81689.0,60913,0.5753779981284783,11764
Georgia,Floyd,24114,9159,1335,42955.0,34608,0.6967753120665742,14955
Georgia,Forsyth,69851,23462,4908,91842.0,98221,0.7111615642276091,46389
Georgia,Franklin,7054,1243,205,37298.0,8502,0.829687132439426,5811
Georgia,Fulton,117783,297051,16557,58851.0,431391,0.2730307308219226,-179268
Georgia,Gilmer,10477,1965,331,43775.0,12773,0.8202458310498708,8512
Georgia,Glascock,1235,138,17,43884.0,1390,0.8884892086330936,1097
Georgia,Glynn,21512,11775,976,46475.0,34263,0.6278492834836412,9737
Georgia,Gordon,15191,3181,587,41390.0,18959,0.8012553404715439,12010
Georgia,Grady,6053,3013,147,35518.0,9213,0.6570064039943558,3040
Georgia,Greene,5490,3199,163,44299.0,8852,0.6201988251242657,2291
Georgia,Gwinnett,146989,166153,15189,61865.0,328331,0.447685415023254,-19164
Georgia,Habersham,13190,2483,570,41600.0,16243,0.8120421104475775,10707
Georgia,Hall,51733,16180,2781,51902.0,70694,0.7317877047557076,35553
Georgia,Hancock,843,2701,36,26386.0,3580,0.23547486033519552,-1858
Georgia,Haralson,9585,1475,297,42281.0,11357,0.8439728801620147,8110
Georgia,Harris,11936,4086,480,65336.0,16502,0.7233062659071627,7850
Georgia,Hart,7286,2585,246,37983.0,10117,0.7201739646140161,4701
Georgia,Heard,3370,743,110,44185.0,4223,0.7980108927302866,2627
Georgia,Henry,45724,50057,2985,62561.0,98766,0.46295283802118137,-4333
Georgia,Houston,35430,22553,2096,55480.0,60079,0.5897235306845986,12877
Georgia,Irwin,2716,891,63,29846.0,3670,0.7400544959128066,1825
Georgia,Jackson,21784,4491,915,54246.0,27190,0.8011769032732622,17293
Georgia,Jasper,4360,1544,141,41434.0,6045,0.7212572373862697,2816
Georgia,Jeff Davis,4104,901,91,36566.0,5096,0.8053375196232339,3203
Georgia,Jefferson,3063,3821,84,28417.0,6968,0.4395809414466131,-758
Georgia,Jenkins,1895,1123,38,27398.0,3056,0.6200916230366492,772
Georgia,Johnson,2519,1136,31,32685.0,3686,0.6833966359196961,1383
Georgia,Jones,8305,3961,285,54020.0,12551,0.6617002629272568,4344
Georgia,Lamar,5190,2270,152,40364.0,7612,0.6818181818181818,2920
Georgia,Lanier,1984,806,81,31682.0,2871,0.6910484151863462,1178
Georgia,Laurens,12411,6752,367,33632.0,19530,0.635483870967742,5659
Georgia,Lee,10646,3170,327,62797.0,14143,0.7527398713144312,7476
Georgia,Liberty,6134,9556,453,42484.0,16143,0.3799789382394846,-3422
Georgia,Lincoln,2759,1273,70,34720.0,4102,0.6725987323256948,1486
Georgia,Long,2626,1360,131,50848.0,4117,0.6378430896283702,1266
Georgia,Lowndes,21635,15064,1106,38915.0,37805,0.572278799100648,6571
Georgia,Lumpkin,9619,2220,586,40634.0,12425,0.7741649899396378,7399
Georgia,McDuffie,5432,3699,137,37021.0,9268,0.5861027190332326,1733
Georgia,McIntosh,3487,2303,113,45248.0,5903,0.5907165847873962,1184
Georgia,Macon,1540,2705,42,28285.0,4287,0.3592255656636342,-1165
Georgia,Madison,9201,2425,372,45063.0,11998,0.7668778129688282,6776
Georgia,Marion,1921,1213,56,35484.0,3190,0.6021943573667712,708
Georgia,Meriwether,5222,3804,191,34989.0,9217,0.566561788000434,1418
Georgia,Miller,1891,623,30,36463.0,2544,0.7433176100628931,1268
Georgia,Mitchell,4279,3493,108,31111.0,7880,0.5430203045685279,786
Georgia,Monroe,8832,3571,284,50625.0,12687,0.6961456609127453,5261
Georgia,Montgomery,2670,847,59,38111.0,3576,0.7466442953020134,1823
Georgia,Morgan,6559,2663,253,54506.0,9475,0.6922427440633245,3896
Georgia,Murray,10341,1800,317,38136.0,12458,0.830069031947343,8541
Georgia,Muscogee,26976,39851,2205,42661.0,69032,0.3907752926179163,-12875
Georgia,Newton,20913,21943,1131,51068.0,43987,0.4754359242503467,-1030
Georgia,Oconee,13425,5581,1143,75946.0,20149,0.6662861680480421,7844
Georgia,Oglethorpe,4625,1831,218,44403.0,6674,0.6929877135151333,2794
Georgia,Paulding,44662,18025,2203,60971.0,64890,0.6882724610879951,26637
Georgia,Peach,5413,5100,239,41128.0,10752,0.5034412202380952,313
Georgia,Pickens,11651,1979,408,56769.0,14038,0.8299615329819062,9672
Georgia,Pierce,6302,903,106,42730.0,7311,0.8619887840240733,5399
Georgia,Pike,7278,1240,207,50819.0,8725,0.8341547277936963,6038
Georgia,Polk,11014,2867,334,39356.0,14215,0.7748153359127682,8147
Georgia,Pulaski,2437,1104,64,38880.0,3605,0.676005547850208,1333
Georgia,Putnam,6544,2758,186,45762.0,9488,0.6897133220910624,3786
Georgia,Quitman,575,461,8,29773.0,1044,0.5507662835249042,114
Georgia,Rabun,6287,1444,261,38277.0,7992,0.7866616616616616,4843
Georgia,Randolph,1271,1598,30,30358.0,2899,0.43842704380820974,-327
Georgia,Richmond,24461,48814,2240,38595.0,75515,0.3239223995232735,-24353
Georgia,Rockdale,13478,23255,1136,51072.0,37869,0.355911167445668,-9777
Georgia,Schley,1472,401,36,41227.0,1909,0.7710843373493976,1071
Georgia,Screven,3305,2300,110,35047.0,5715,0.5783027121609798,1005
Georgia,Seminole,2345,1189,54,35410.0,3588,0.6535674470457079,1156
Georgia,Spalding,15646,9357,701,40548.0,25704,0.6086990351696234,6289
Georgia,Stephens,7686,1837,292,37088.0,9815,0.7830871115639327,5849
Georgia,Stewart,805,1222,31,20882.0,2058,0.391156462585034,-417
Georgia,Sumter,5276,5520,178,33534.0,10974,0.4807727355567705,-244
Georgia,Talbot,1196,2002,48,36957.0,3246,0.36845348120764015,-806
Georgia,Taliaferro,349,545,3,28152.0,897,0.3890746934225195,-196
Georgia,Tattnall,5096,1681,126,35578.0,6903,0.7382297551789078,3415
Georgia,Taylor,2064,1296,48,27114.0,3408,0.6056338028169014,768
Georgia,Telfair,2450,1313,33,27657.0,3796,0.6454162276080084,1137
Georgia,Terrell,1874,2267,48,30438.0,4189,0.44736213893530674,-393
Georgia,Thomas,11228,7142,432,38241.0,18802,0.5971705137751303,4086
Georgia,Tift,9584,4347,288,37613.0,14219,0.6740277094029116,5237
Georgia,Toombs,6615,2338,185,33081.0,9138,0.7239001969796455,4277
Georgia,Towns,5383,1210,171,39321.0,6764,0.7958308693081018,4173
Georgia,Treutlen,1809,862,32,40204.0,2703,0.6692563817980022,947
Georgia,Troup,15750,9713,648,42545.0,26111,0.6031940561449197,6037
Georgia,Turner,2095,1246,57,34667.0,3398,0.6165391406709829,849
Georgia,Twiggs,2035,1971,53,31625.0,4059,0.5013550135501355,64
Georgia,Union,9852,1963,248,41686.0,12063,0.8167122606316837,7889
Georgia,Upson,7292,3475,167,35699.0,10934,0.6669105542344979,3817
Georgia,Walker,18950,4215,791,41539.0,23956,0.7910335615294707,14735
Georgia,Walton,31125,8292,1281,54459.0,40698,0.7647795960489459,22833
Georgia,Ware,8513,3440,231,34705.0,12184,0.6987032173342088,5073
Georgia,Warren,991,1314,29,31875.0,2334,0.4245929734361611,-323
Georgia,Washington,4149,4200,112,37417.0,8461,0.49036756884529015,-51
Georgia,Wayne,8153,2041,219,39908.0,10413,0.7829636031883223,6112
Georgia,Webster,630,473,13,37072.0,1116,0.5645161290322581,157
Georgia,Wheeler,1421,646,35,27779.0,2102,0.6760228353948621,775
Georgia,White,9761,1674,388,42264.0,11823,0.8255941808339677,8087
Georgia,Whitfield,21537,7937,1184,41764.0,30658,0.7024920086111293,13600
Georgia,Wilcox,2096,852,28,34071.0,2976,0.7043010752688172,1244
Georgia,Wilkes,2572,1848,66,33462.0,4486,0.5733392777530094,724
Georgia,Wilkinson,2333,1894,60,38827.0,4287,0.5442034056449732,439
Georgia,Worth,6152,2020,123,38684.0,8295,0.7416515973477998,4132
Hawaii,Hawaii,17501,41259,6107,53936.0,64867,0.2697982024758352,-23758
Hawaii,Honolulu,90326,175696,19768,77161.0,285790,0.31605724483012004,-85370
Hawaii,Kauai,7574,16456,2305,68224.0,26335,0.2876020505031327,-8882
Hawaii,Maui,13446,33480,5019,68777.0,51945,0.2588507074790644,-20034
Idaho,Ada,93752,75677,26240,58099.0,195669,0.47913568322013195,18075
Idaho,Adams,1556,415,212,41335.0,2183,0.7127805771873569,1141
Idaho,Bannock,17180,10342,5894,45216.0,33416,0.514124970074216,6838
Idaho,Bear Lake,2203,255,470,46863.0,2928,0.7523907103825137,1948
Idaho,Benewah,3103,770,312,42600.0,4185,0.741457586618877,2333
Idaho,Bingham,10907,2924,2794,49943.0,16625,0.6560601503759399,7983
Idaho,Blaine,3340,6416,968,58086.0,10724,0.3114509511376352,-3076
Idaho,Boise,2673,777,364,44591.0,3814,0.7008390141583639,1896
Idaho,Bonner,13343,5819,1781,43697.0,20943,0.6371102516353913,7524
Idaho,Bonneville,26699,8930,8592,52831.0,44221,0.6037629180705999,17769
Idaho,Boundary,3789,933,441,39279.0,5163,0.7338756536897153,2856
Idaho,Butte,914,160,156,39653.0,1230,0.7430894308943089,754
Idaho,Camas,410,110,70,42708.0,590,0.6949152542372882,300
Idaho,Canyon,47222,16883,8680,44860.0,72785,0.648787524902109,30339
Idaho,Caribou,2275,271,489,57957.0,3035,0.7495881383855024,2004
Idaho,Cassia,5949,1036,1193,46215.0,8178,0.727439471753485,4913
Idaho,Clark,203,44,36,32422.0,283,0.7173144876325088,159
Idaho,Clearwater,2852,704,245,40266.0,3801,0.7503288608260984,2148
Idaho,Custer,1777,427,210,39497.0,2414,0.7361226180613091,1350
Idaho,Elmore,5816,1814,892,44444.0,8522,0.6824689040131424,4002
Idaho,Franklin,3901,385,1213,50500.0,5499,0.7094017094017094,3516
Idaho,Fremont,4090,651,974,49973.0,5715,0.715660542432196,3439
Idaho,Gem,5980,1229,745,40767.0,7954,0.7518229821473472,4751
Idaho,Gooding,3743,930,518,40704.0,5191,0.7210556732806781,2813
Idaho,Idaho,6441,1196,596,38597.0,8233,0.7823393659662334,5245
Idaho,Jefferson,8436,976,2063,54646.0,11475,0.7351633986928104,7460
Idaho,Jerome,4644,1329,778,44447.0,6751,0.6878980891719745,3315
Idaho,Kootenai,44449,16264,5597,50924.0,66310,0.6703212185190771,28185
Idaho,Latah,7265,8093,2815,42133.0,18173,0.39976888791063664,-828
Idaho,Lemhi,3011,733,352,34762.0,4096,0.735107421875,2278
Idaho,Lewis,1202,270,118,38068.0,1590,0.7559748427672957,932
Idaho,Lincoln,1184,360,204,44500.0,1748,0.6773455377574371,824
Idaho,Madison,8941,1201,5546,33856.0,15688,0.5699260581336053,7740
Idaho,Minidoka,4887,1167,817,46147.0,6871,0.7112501819240286,3720
Idaho,Nez Perce,10699,4828,1674,49541.0,17201,0.6219987210045927,5871
Idaho,Oneida,1531,184,353,40564.0,2068,0.7403288201160542,1347
Idaho,Owyhee,3052,591,282,34785.0,3925,0.7775796178343949,2461
Idaho,Payette,6489,1507,708,45670.0,8704,0.7455193014705882,4982
Idaho,Power,1666,699,393,46318.0,2758,0.6040609137055838,967
Idaho,Shoshone,3297,1384,439,37449.0,5120,0.6439453125,1913
Idaho,Teton,2167,2159,650,58173.0,4976,0.4354903536977492,8
Idaho,Twin Falls,19828,6233,3813,45500.0,29874,0.6637209613710919,13595
Idaho,Valley,2906,1913,530,53630.0,5349,0.5432791175920733,993
Idaho,Washington,3283,776,396,37525.0,4455,0.7369248035914703,2507
Illinois,Adams,22790,7676,1485,48065.0,31951,0.7132797095552564,15114
Illinois,Alexander,1496,1262,88,29071.0,2846,0.5256500351370345,234
Illinois,Bond,4888,2068,574,52159.0,7530,0.6491367861885791,2820
Illinois,Boone,12282,8986,1733,60063.0,23001,0.5339767836181035,3296
Illinois,Brown,1796,476,107,52500.0,2379,0.7549390500210172,1320
Illinois,Bureau,9281,6029,1261,51425.0,16571,0.5600748295214532,3252
Illinois,Calhoun,1721,739,111,52949.0,2571,0.6693893426682225,982
Illinois,Carroll,4434,2447,564,50052.0,7445,0.5955674949630625,1987
Illinois,Cass,3216,1621,287,48887.0,5124,0.6276346604215457,1595
Illinois,Champaign,33368,50137,8123,48899.0,91628,0.36416815820491555,-16769
Illinois,Christian,10543,3992,924,47417.0,15459,0.6819975418849861,6551
Illinois,Clark,5622,1877,429,48693.0,7928,0.7091321897073662,3745
Illinois,Clay,5021,1020,309,45984.0,6350,0.7907086614173229,4001
Illinois,Clinton,12412,3945,1062,63929.0,17419,0.7125552557552098,8467
Illinois,Coles,13003,7309,1551,38800.0,21863,0.5947491195169922,5694
Illinois,Cook,453287,1611946,93382,56902.0,2158615,0.20998973879084507,-1158659
Illinois,Crawford,6277,1992,459,47364.0,8728,0.719179651695692,4285
Illinois,Cumberland,4206,1031,330,44281.0,5567,0.7555236213400395,3175
Illinois,DeKalb,19091,20466,4043,56076.0,43600,0.43786697247706424,-1375
Illinois,De Witt,5077,1910,556,53510.0,7543,0.6730743735914092,3167
Illinois,Douglas,5698,1949,522,52984.0,8169,0.6975149957155099,3749
Illinois,DuPage,166415,228622,33732,81521.0,428769,0.3881227420825666,-62207
Illinois,Edgar,5645,1793,435,46440.0,7873,0.7170074939667217,3852
Illinois,Edwards,2778,434,135,47035.0,3347,0.829997012249776,2344
Illinois,Effingham,13635,3083,891,52977.0,17609,0.7743199500255551,10552
Illinois,Fayette,7372,1819,394,44745.0,9585,0.7691184141888368,5553
Illinois,Ford,4480,1414,502,49257.0,6396,0.7004377736085053,3066
Illinois,Franklin,13116,4727,868,39507.0,18711,0.7009780343113676,8389
Illinois,Fulton,8492,6133,1172,46183.0,15797,0.5375704247641957,2359
Illinois,Gallatin,1942,657,108,41269.0,2707,0.717399335057259,1285
Illinois,Greene,4145,1205,235,42880.0,5585,0.7421665174574754,2940
Illinois,Grundy,13454,8065,1718,67162.0,23237,0.5789904032362181,5389
Illinois,Hamilton,3206,802,158,45076.0,4166,0.7695631301008161,2404
Illinois,Hancock,6430,2139,552,50077.0,9121,0.7049665606841355,4291
Illinois,Hardin,1653,420,75,39926.0,2148,0.7695530726256983,1233
Illinois,Henderson,2155,1155,208,46216.0,3518,0.6125639567936327,1000
Illinois,Henry,13985,8871,1787,54757.0,24643,0.5675039564988029,5114
Illinois,Iroquois,9750,2504,810,47823.0,13064,0.7463257807715861,7246
Illinois,Jackson,10843,11634,2140,33845.0,24617,0.44046796928951537,-791
Illinois,Jasper,3975,924,237,56305.0,5136,0.7739485981308412,3051
Illinois,Jefferson,11695,4425,879,43467.0,16999,0.6879816459791752,7270
Illinois,Jersey,7748,2679,564,52738.0,10991,0.7049404057865526,5069
Illinois,Jo Daviess,6121,4462,751,54702.0,11334,0.5400564672666314,1659
Illinois,Johnson,4649,1142,298,44179.0,6089,0.7635079651831171,3507
Illinois,Kane,82734,103665,12915,71602.0,199314,0.4150937716367139,-20931
Illinois,Kankakee,25129,18971,3205,54697.0,47305,0.531212345418032,6158
Illinois,Kendall,24961,24884,3602,85736.0,53447,0.4670234063651842,77
Illinois,Knox,10737,10083,1423,40605.0,22243,0.4827136627253518,654
Illinois,Lake,109767,171095,22658,79886.0,303520,0.36164667896678965,-61328
Illinois,LaSalle,26689,19543,3511,51684.0,49743,0.5365378043141749,7146
Illinois,Lawrence,4521,1290,283,42650.0,6094,0.7418772563176895,3231
Illinois,Lee,8612,5528,1349,55067.0,15489,0.5560074891858738,3084
Illinois,Livingston,10208,4023,1038,54074.0,15269,0.668544108978977,6185
Illinois,Logan,8181,3313,907,52676.0,12401,0.6597048625110878,4868
Illinois,McDonough,6795,5288,1009,41484.0,13092,0.519019248395967,1507
Illinois,McHenry,71612,60803,9335,79836.0,141750,0.5051992945326279,10809
Illinois,McLean,37237,36196,6402,63420.0,79835,0.46642450053234796,1041
Illinois,Macon,26866,18343,2851,47477.0,48060,0.5590095713691219,8523
Illinois,Macoupin,14322,6689,1349,52337.0,22360,0.6405187835420394,7633
Illinois,Madison,70490,50587,9102,54573.0,130179,0.5414851857826531,19903
Illinois,Marion,11859,4369,846,43427.0,17074,0.6945648354222795,7490
Illinois,Marshall,3785,1789,410,54189.0,5984,0.6325200534759359,1996
Illinois,Mason,4058,2014,414,43125.0,6486,0.6256552574776442,2044
Illinois,Massac,4846,1558,279,42706.0,6683,0.7251234475534939,3288
Illinois,Menard,4231,1817,467,60420.0,6515,0.649424405218726,2414
Illinois,Mercer,4807,3071,647,55750.0,8525,0.5638709677419355,1736
Illinois,Monroe,12629,5535,1190,72956.0,19354,0.6525266094864111,7094
Illinois,Montgomery,8630,3504,844,45173.0,12978,0.6649714902142086,5126
Illinois,Morgan,9076,4696,1028,47760.0,14800,0.6132432432432432,4380
Illinois,Moultrie,4455,1481,347,51432.0,6283,0.7090561833519019,2974
Illinois,Ogle,14352,8050,1791,55832.0,24193,0.5932294465341215,6302
Illinois,Peoria,35633,38060,4810,51632.0,78503,0.4539062201444531,-2427
Illinois,Perry,6855,2462,536,43308.0,9853,0.6957271896884197,4393
Illinois,Piatt,5634,2645,729,69160.0,9008,0.6254440497335702,2989
Illinois,Pike,5754,1413,363,40157.0,7530,0.7641434262948207,4341
Illinois,Pope,1678,375,89,39243.0,2142,0.7833800186741363,1303
Illinois,Pulaski,1675,962,98,32538.0,2735,0.6124314442413162,713
Illinois,Putnam,1767,1147,197,64085.0,3111,0.5679845708775313,620
Illinois,Randolph,10023,3439,732,48343.0,14194,0.7061434408905172,6584
Illinois,Richland,5739,1584,361,45597.0,7684,0.7468766267568975,4155
Illinois,Rock Island,26998,32298,4698,50208.0,63994,0.4218833015595212,-5300
Illinois,St. Clair,53857,60756,5967,50006.0,120580,0.4466495272847902,-6899
Illinois,Saline,8276,2572,536,40290.0,11384,0.7269852424455376,5704
Illinois,Sangamon,49944,40907,7522,56742.0,98373,0.5077002836144064,9037
Illinois,Schuyler,2524,1075,229,48396.0,3828,0.6593521421107628,1449
Illinois,Scott,1966,535,107,46210.0,2608,0.7538343558282209,1431
Illinois,Shelby,8229,2288,493,48572.0,11010,0.7474114441416894,5941
Illinois,Stark,1778,751,214,52058.0,2743,0.6481954064892453,1027
Illinois,Stephenson,11083,7768,1492,45624.0,20343,0.5448065673696112,3315
Illinois,Tazewell,38707,20685,5008,60178.0,64400,0.6010403726708075,18022
Illinois,Union,5790,2402,345,45464.0,8537,0.6782242005388309,3388
Illinois,Vermilion,19087,10039,1444,43552.0,30570,0.6243702976774615,9048
Illinois,Wabash,4047,1151,266,46871.0,5464,0.7406661786237189,2896
Illinois,Warren,4275,2987,545,44067.0,7807,0.5475855001921353,1288
Illinois,Washington,5571,1448,408,54936.0,7427,0.7501009829002289,4123
Illinois,Wayne,6967,1048,246,46903.0,8261,0.8433603679941896,5919
Illinois,White,5640,1412,283,43678.0,7335,0.7689161554192229,4228
Illinois,Whiteside,12615,11035,1932,49151.0,25582,0.4931201626143382,1580
Illinois,Will,132720,151927,16257,77507.0,300904,0.44107090633557544,-19207
Illinois,Williamson,21570,8581,1701,45902.0,31852,0.6771945246766294,12989
Illinois,Winnebago,55624,55713,7039,49468.0,118376,0.469892545786308,-89
Illinois,Woodford,13207,5092,1565,68040.0,19864,0.6648711236407572,8115
Indiana,Adams,9648,2805,637,47572.0,13090,0.7370511841100076,6843
Indiana,Allen,83930,55382,7825,49574.0,147137,0.5704207643216866,28548
Indiana,Bartholomew,20640,9841,2009,55874.0,32490,0.6352723915050785,10799
Indiana,Benton,2579,860,227,48069.0,3666,0.7034915439170758,1719
Indiana,Blackford,3350,1243,246,38791.0,4839,0.6922917958255838,2107
Indiana,Boone,19654,10181,2343,72774.0,32178,0.6107899807321773,9473
Indiana,Brown,5016,2518,411,56323.0,7945,0.6313404657016992,2498
Indiana,Carroll,6273,1892,478,54140.0,8643,0.7257896563693162,4381
Indiana,Cass,9701,3759,749,43918.0,14209,0.6827362938982335,5942
Indiana,Clark,30035,18808,2304,51844.0,51147,0.587228967485874,11227
Indiana,Clay,8531,2306,445,49735.0,11282,0.7561602552738876,6225
Indiana,Clinton,8531,2819,586,50096.0,11936,0.7147285522788204,5712
Indiana,Crawford,3015,1323,255,41173.0,4593,0.6564337034617896,1692
Indiana,Daviess,8545,1800,423,47939.0,10768,0.7935549777117384,6745
Indiana,Dearborn,18113,4883,991,60834.0,23987,0.7551173552340851,13230
Indiana,Decatur,8490,2121,516,51185.0,11127,0.763008897276894,6369
Indiana,DeKalb,12054,3942,906,50398.0,16902,0.7131700390486333,8112
Indiana,Delaware,24263,18153,2707,39537.0,45123,0.5377080424617158,6110
Indiana,Dubois,13365,5389,1230,55154.0,19984,0.6687850280224179,7976
Indiana,Elkhart,41867,20740,3023,49692.0,65630,0.6379247295444157,21127
Indiana,Fayette,6839,2252,439,40851.0,9530,0.7176285414480588,4587
Indiana,Floyd,21432,13945,2048,57494.0,37425,0.5726653306613226,7487
Indiana,Fountain,5662,1476,354,45924.0,7492,0.7557394554191137,4186
Indiana,Franklin,8669,1969,375,52128.0,11013,0.7871606283483156,6700
Indiana,Fulton,6010,1960,404,46310.0,8374,0.7176976355385718,4050
Indiana,Gibson,11081,3721,682,49669.0,15484,0.7156419529837251,7360
Indiana,Grant,17008,7010,1294,40272.0,25312,0.6719342604298356,9998
Indiana,Greene,10277,2929,595,45153.0,13801,0.7446561843344686,7348
Indiana,Hamilton,87404,57263,9589,87782.0,154256,0.5666165335546105,30141
Indiana,Hancock,25074,8904,2203,68449.0,36181,0.6930156712086454,16170
Indiana,Harrison,12943,4783,832,52926.0,18558,0.6974350684340985,8160
Indiana,Hendricks,48337,22600,4622,73042.0,75559,0.6397252478195847,25737
Indiana,Henry,13895,5124,1136,44509.0,20155,0.6894070950136443,8771
Indiana,Howard,23675,11215,1953,45928.0,36843,0.6425915370626714,12460
Indiana,Huntington,11649,3506,888,47042.0,16043,0.7261110764819547,8143
Indiana,Jackson,12859,3843,871,48546.0,17573,0.7317475672907301,9016
Indiana,Jasper,9382,3329,667,55485.0,13378,0.7013006428464643,6053
Indiana,Jay,5697,1889,400,42322.0,7986,0.713373403456048,3808
Indiana,Jefferson,8546,4326,672,47065.0,13544,0.6309805079740106,4220
Indiana,Jennings,8224,2364,562,47236.0,11150,0.7375784753363229,5860
Indiana,Johnson,45456,17318,3726,63023.0,66500,0.6835488721804511,28138
Indiana,Knox,11077,3772,667,44624.0,15516,0.7139082237690126,7305
Indiana,Kosciusko,23935,6313,1836,54482.0,32084,0.7460104725096621,17622
Indiana,LaGrange,7025,2080,461,53947.0,9566,0.7343717332218272,4945
Indiana,Lake,75625,116935,8645,50905.0,201205,0.3758604408439154,-41310
Indiana,LaPorte,22687,19798,2718,48165.0,45203,0.5018914673804836,2889
Indiana,Lawrence,14035,4210,907,46044.0,19152,0.7328216374269005,9825
Indiana,Madison,32376,18595,2938,44795.0,53909,0.6005676232169026,13781
Indiana,Marion,130360,212899,19113,43369.0,362372,0.3597408188270617,-82539
Indiana,Marshall,12288,4798,996,49725.0,18082,0.6795708439331932,7490
Indiana,Martin,3697,881,231,47457.0,4809,0.76876689540445,2816
Indiana,Miami,9975,2766,741,45646.0,13482,0.7398753894080997,7209
Indiana,Monroe,20592,34216,3646,43389.0,58454,0.3522770041400075,-13624
Indiana,Montgomery,11059,3362,735,50253.0,15156,0.729678015307469,7697
Indiana,Morgan,23674,6040,1566,57521.0,31280,0.756841432225064,17634
Indiana,Newton,4077,1404,314,50058.0,5795,0.7035375323554789,2673
Indiana,Noble,12198,3904,788,49657.0,16890,0.722202486678508,8294
Indiana,Ohio,2118,686,117,54653.0,2921,0.7250941458404656,1432
Indiana,Orange,5803,2048,341,41438.0,8192,0.7083740234375,3755
Indiana,Owen,6153,1946,458,45388.0,8557,0.7190604183709244,4207
Indiana,Parke,4863,1441,278,42664.0,6582,0.7388331814038286,3422
Indiana,Perry,4556,3062,437,47396.0,8055,0.5656114214773432,1494
Indiana,Pike,4398,1297,282,48076.0,5977,0.7358206458089342,3101
Indiana,Porter,38832,33676,4682,64874.0,77190,0.503070345899728,5156
Indiana,Posey,8404,3521,542,59918.0,12467,0.6740996230047325,4883
Indiana,Pulaski,3854,1327,278,44884.0,5459,0.7059901080784027,2527
Indiana,Putnam,10637,3356,722,52465.0,14715,0.7228678219503908,7281
Indiana,Randolph,7517,2446,495,42418.0,10458,0.7187798814304839,5071
Indiana,Ripley,9806,2471,533,52372.0,12810,0.7654957064793131,7335
Indiana,Rush,5292,1525,397,46380.0,7214,0.7335736068755199,3767
Indiana,St. Joseph,52021,52252,5787,46174.0,110060,0.4726603670725059,-231
Indiana,Scott,6074,2642,385,46368.0,9101,0.6673991869025382,3432
Indiana,Shelby,12718,4247,1029,52651.0,17994,0.7067911526064243,8471
Indiana,Spencer,6572,2861,546,54870.0,9979,0.6585830243511374,3711
Indiana,Starke,6367,2489,370,43401.0,9226,0.6901148926945588,3878
Indiana,Steuben,10133,3744,689,50418.0,14566,0.6956611286557737,6389
Indiana,Sullivan,6138,2113,308,43786.0,8559,0.7171398527865405,4025
Indiana,Switzerland,2558,930,211,43456.0,3699,0.6915382535820492,1628
Indiana,Tippecanoe,30768,27282,4465,47406.0,62515,0.49216987922898503,3486
Indiana,Tipton,5589,1587,334,54023.0,7510,0.7442077230359521,4002
Indiana,Union,2445,715,131,45104.0,3291,0.7429352780309936,1730
Indiana,Vanderburgh,40496,28530,3481,43311.0,72507,0.5585115919842222,11966
Indiana,Vermillion,4513,2081,345,44409.0,6939,0.6503818994091367,2432
Indiana,Vigo,21937,15931,1950,41221.0,39818,0.5509317394143353,6006
Indiana,Wabash,9821,3018,629,47473.0,13468,0.7292099792099792,6803
Indiana,Warren,2898,839,193,58623.0,3930,0.7374045801526717,2059
Indiana,Warrick,19113,9086,1390,61542.0,29589,0.645949508263206,10027
Indiana,Washington,8209,2636,537,44883.0,11382,0.7212264979792655,5573
Indiana,Wayne,16028,8322,1229,39691.0,25579,0.6266077641815552,7706
Indiana,Wells,10005,2586,594,51568.0,13185,0.7588168373151308,7419
Indiana,White,6893,2590,570,51547.0,10053,0.6856659703571073,4303
Indiana,Whitley,11358,3379,886,54837.0,15623,0.7270050566472509,7979
Iowa,Adair,2461,1133,217,48765.0,3811,0.6457622671214904,1328
Iowa,Adams,1395,565,146,48598.0,2106,0.6623931623931624,830
Iowa,Allamakee,4093,2421,409,48089.0,6923,0.5912176801964466,1672
Iowa,Appanoose,4033,1814,289,40817.0,6136,0.6572685788787483,2219
Iowa,Audubon,2136,1080,196,47048.0,3412,0.6260257913247362,1056
Iowa,Benton,8232,4678,934,61222.0,13844,0.5946258306847731,3554
Iowa,Black Hawk,27476,32233,4696,50348.0,64405,0.42661284061796445,-4757
Iowa,Boone,7484,5541,1171,54513.0,14196,0.5271907579599887,1943
Iowa,Bremer,7208,5356,974,64264.0,13538,0.5324272418377899,1852
Iowa,Buchanan,5510,3970,772,55881.0,10252,0.537456106125634,1540
Iowa,Buena Vista,4903,2856,519,49942.0,8278,0.5922928243537087,2047
Iowa,Butler,4921,2157,435,52204.0,7513,0.6549980034606682,2764
Iowa,Calhoun,3468,1398,293,44635.0,5159,0.6722232990889707,2070
Iowa,Carroll,6638,3309,597,53785.0,10544,0.6295523520485584,3329
Iowa,Cass,4761,1951,413,45469.0,7125,0.6682105263157895,2810
Iowa,Cedar,5295,3599,647,60435.0,9541,0.5549732732417986,1696
Iowa,Cerro Gordo,11621,9862,1482,47788.0,22965,0.506030916612236,1759
Iowa,Cherokee,4192,1679,387,51590.0,6258,0.6698625759028444,2513
Iowa,Chickasaw,3742,2266,427,48013.0,6435,0.5815073815073815,1476
Iowa,Clarke,2713,1465,276,46510.0,4454,0.6091154018859453,1248
Iowa,Clay,5877,2249,491,48888.0,8617,0.6820239062318673,3628
Iowa,Clayton,5317,3237,575,48482.0,9129,0.5824296198926499,2080
Iowa,Clinton,11276,10095,1696,50067.0,23067,0.48883686651926994,1181
Iowa,Crawford,4617,1991,327,49699.0,6935,0.6657534246575343,2626
Iowa,Dallas,19339,15701,3212,78918.0,38252,0.5055683362961414,3638
Iowa,Davis,2723,977,182,49696.0,3882,0.7014425553838227,1746
Iowa,Decatur,2296,1201,237,38467.0,3734,0.6148901981788967,1095
Iowa,Delaware,5694,2957,590,59452.0,9241,0.6161670814846878,2737
Iowa,Des Moines,9529,8212,1362,44516.0,19103,0.4988221745275611,1317
Iowa,Dickinson,6753,3056,545,57914.0,10354,0.652211705621016,3697
Iowa,Dubuque,23460,22850,3411,56154.0,49721,0.47183282717564007,610
Iowa,Emmet,3124,1357,272,45536.0,4753,0.657269093204292,1767
Iowa,Fayette,5620,3689,666,47711.0,9975,0.5634085213032581,1931
Iowa,Floyd,4375,3179,506,46406.0,8060,0.542803970223325,1196
Iowa,Franklin,3163,1493,312,47524.0,4968,0.6366747181964574,1670
Iowa,Fremont,2407,963,225,52922.0,3595,0.6695410292072322,1444
Iowa,Greene,2820,1691,310,47264.0,4821,0.5849408836341008,1129
Iowa,Grundy,4527,1856,489,61606.0,6872,0.6587601862630966,2671
Iowa,Guthrie,3628,1732,390,52702.0,5750,0.6309565217391304,1896
Iowa,Hamilton,4463,2726,505,53970.0,7694,0.5800623862750195,1737
Iowa,Hancock,3977,1587,307,54813.0,5871,0.6773973769374894,2390
Iowa,Hardin,5254,2787,492,51821.0,8533,0.6157271768428454,2467
Iowa,Harrison,4902,2131,432,55845.0,7465,0.6566644340254522,2771
Iowa,Henry,5779,2904,721,49606.0,9404,0.6145257337303275,2875
Iowa,Howard,2611,1677,271,49199.0,4559,0.5727133143233165,934
Iowa,Humboldt,3568,1252,267,47478.0,5087,0.7013957145665421,2316
Iowa,Ida,2655,792,165,49957.0,3612,0.7350498338870431,1863
Iowa,Iowa,5205,3084,615,55099.0,8904,0.5845687331536388,2121
Iowa,Jackson,5824,3837,649,49115.0,10310,0.5648884578079535,1987
Iowa,Jasper,10560,7109,1365,55503.0,19034,0.5547966796259325,3451
Iowa,Jefferson,3748,3710,698,45257.0,8156,0.45953898970083373,38
Iowa,Johnson,21044,50200,5696,56808.0,76940,0.2735118273979725,-29156
Iowa,Jones,5720,3787,626,55507.0,10133,0.5644922530346393,1933
Iowa,Keokuk,3390,1342,253,45227.0,4985,0.6800401203610833,2048
Iowa,Kossuth,5653,2543,411,54231.0,8607,0.6567909840827234,3110
Iowa,Lee,8803,6215,1133,44568.0,16151,0.5450436505479537,2588
Iowa,Linn,48390,58935,9773,60989.0,117098,0.413243607918154,-10545
Iowa,Louisa,3069,1648,291,51615.0,5008,0.6128194888178914,1421
Iowa,Lucas,2877,1239,238,48768.0,4354,0.6607717041800643,1638
Iowa,Lyon,5192,920,265,59888.0,6377,0.8141759448016309,4272
Iowa,Madison,5360,2678,598,60326.0,8636,0.6206577119036591,2682
Iowa,Mahaska,7432,2619,581,49599.0,10632,0.6990218209179835,4813
Iowa,Marion,10962,5482,1372,57412.0,17816,0.6152896273013022,5480
Iowa,Marshall,9146,7652,1182,54193.0,17980,0.5086763070077864,1494
Iowa,Mills,5067,2090,541,66203.0,7698,0.6582229150428682,2977
Iowa,Mitchell,3190,1888,339,52564.0,5417,0.5888868377330626,1302
Iowa,Monona,3120,1247,205,41455.0,4572,0.6824146981627297,1873
Iowa,Monroe,2638,1056,171,47515.0,3865,0.682535575679172,1582
Iowa,Montgomery,3436,1314,294,42641.0,5044,0.6812053925455988,2122
Iowa,Muscatine,9584,8368,1482,55971.0,19434,0.493156323968303,1216
Iowa,O'Brien,5752,1315,339,52474.0,7406,0.7766675668376991,4437
Iowa,Osceola,2531,552,130,48457.0,3213,0.7877373171490819,1979
Iowa,Page,4893,1807,344,46128.0,7044,0.694633730834753,3086
Iowa,Palo Alto,3081,1398,224,49109.0,4703,0.6551137571762705,1683
Iowa,Plymouth,9680,2885,625,60339.0,13190,0.7338893100833965,6795
Iowa,Pocahontas,2702,963,200,46250.0,3865,0.6990944372574386,1739
Iowa,Polk,93492,119804,18259,61684.0,231555,0.40375720671114856,-26312
Iowa,Pottawattamie,24447,15355,2878,53260.0,42680,0.5727975632614808,9092
Iowa,Poweshiek,4946,4304,583,50725.0,9833,0.5030001016983626,642
Iowa,Ringgold,1824,753,130,46927.0,2707,0.6738086442556336,1071
Iowa,Sac,3703,1270,239,49570.0,5212,0.7104758250191865,2433
Iowa,Scott,39149,40440,6631,56454.0,86220,0.454059382973788,-1291
Iowa,Shelby,4362,1662,346,52757.0,6370,0.6847723704866562,2700
Iowa,Sioux,14785,2300,1109,63466.0,18194,0.8126305375398483,12485
Iowa,Story,19458,25709,5500,51201.0,50667,0.38403694712534786,-6251
Iowa,Tama,4971,3196,585,53833.0,8752,0.5679844606946983,1775
Iowa,Taylor,2111,758,160,46510.0,3029,0.6969296797622978,1353
Iowa,Union,3525,1922,385,45934.0,5832,0.6044238683127572,1603
Iowa,Van Buren,2527,845,189,46769.0,3561,0.7096321258073575,1682
Iowa,Wapello,8715,5594,840,42494.0,15149,0.5752854973925672,3121
Iowa,Warren,14814,10411,2075,67090.0,27300,0.5426373626373626,4403
Iowa,Washington,6173,3943,813,56864.0,10929,0.5648275231036691,2230
Iowa,Wayne,2069,719,152,42088.0,2940,0.7037414965986395,1350
Iowa,Webster,10056,6305,1069,42196.0,17430,0.5769363166953528,3751
Iowa,Winnebago,3447,1931,409,49278.0,5787,0.5956454121306376,1516
Iowa,Winneshiek,5344,5254,764,57009.0,11362,0.4703397289209646,90
Iowa,Woodbury,24727,16210,2781,49010.0,43718,0.5656022690882474,8517
Iowa,Worth,2453,1530,274,49472.0,4257,0.5762273901808785,923
Iowa,Wright,3800,1896,330,46071.0,6026,0.6306007301692665,1904
Kansas,Allen,3651,1433,370,40911.0,5454,0.6694169416941694,2218
Kansas,Anderson,2435,672,243,42146.0,3350,0.7268656716417911,1763
Kansas,Atchison,4049,1989,537,46103.0,6575,0.6158174904942966,2060
Kansas,Barber,1850,286,116,49455.0,2252,0.8214920071047958,1564
Kansas,Barton,7888,1839,542,44449.0,10269,0.7681371116953939,6049
Kansas,Bourbon,4424,1336,333,41529.0,6093,0.7260791071721647,3088
Kansas,Brown,2906,863,267,44672.0,4036,0.72001982160555,2043
Kansas,Butler,19073,6573,2011,60338.0,27657,0.6896264960046281,12500
Kansas,Chase,969,316,84,41889.0,1369,0.7078159240321402,653
Kansas,Chautauqua,1236,197,48,37927.0,1481,0.8345712356515868,1039
Kansas,Cherokee,6182,2005,433,41240.0,8620,0.717169373549884,4177
Kansas,Cheyenne,1173,181,53,46058.0,1407,0.8336886993603412,992
Kansas,Clark,825,120,60,42976.0,1005,0.8208955223880597,705
Kansas,Clay,2891,677,252,53041.0,3820,0.756806282722513,2214
Kansas,Cloud,2919,761,250,40947.0,3930,0.7427480916030534,2158
Kansas,Coffey,3050,727,291,57442.0,4068,0.7497541789577188,2323
Kansas,Comanche,715,102,50,43542.0,867,0.8246828143021915,613
Kansas,Cowley,8270,3551,800,44960.0,12621,0.6552571111639331,4719
Kansas,Crawford,8624,5199,1068,37607.0,14891,0.5791417634812974,3425
Kansas,Decatur,1210,178,64,41362.0,1452,0.8333333333333334,1032
Kansas,Dickinson,6029,1609,572,48093.0,8210,0.7343483556638246,4420
Kansas,Doniphan,2606,587,185,49375.0,3378,0.7714624037892244,2019
Kansas,Douglas,14688,31195,4204,52698.0,50087,0.2932497454429293,-16507
Kansas,Edwards,1037,212,70,48684.0,1319,0.7862016679302501,825
Kansas,Elk,1048,160,51,37393.0,1259,0.8324066719618745,888
Kansas,Ellis,8466,2742,739,50140.0,11947,0.7086297815351135,5724
Kansas,Ellsworth,1969,521,189,49134.0,2679,0.7349757372153789,1448
Kansas,Finney,6350,3195,614,50712.0,10159,0.6250615218033271,3155
Kansas,Ford,5114,2149,455,49688.0,7718,0.6626068929774553,2965
Kansas,Franklin,7185,2892,888,51465.0,10965,0.655266757865937,4293
Kansas,Geary,4274,2722,508,45243.0,7504,0.5695628997867804,1552
Kansas,Gove,1140,149,54,46681.0,1343,0.8488458674609084,991
Kansas,Graham,1025,188,71,45982.0,1284,0.7982866043613707,837
Kansas,Grant,1804,441,144,54919.0,2389,0.7551276684805358,1363
Kansas,Gray,1698,263,105,59629.0,2066,0.8218780251694094,1435
Kansas,Greeley,534,83,33,47000.0,650,0.8215384615384616,451
Kansas,Greenwood,2160,485,195,39671.0,2840,0.7605633802816901,1675
Kansas,Hamilton,705,121,50,48523.0,876,0.8047945205479452,584
Kansas,Harper,1996,393,189,46886.0,2578,0.7742435996896819,1603
Kansas,Harvey,8668,5068,1180,52463.0,14916,0.5811209439528023,3600
Kansas,Haskell,1040,245,69,55453.0,1354,0.7680945347119645,795
Kansas,Hodgeman,855,124,38,56250.0,1017,0.8407079646017699,731
Kansas,Jackson,3939,1512,367,54700.0,5818,0.67703678239945,2427
Kansas,Jefferson,5213,2518,606,56777.0,8337,0.6252848746551517,2695
Kansas,Jewell,1223,180,91,37750.0,1494,0.8186077643908969,1043
Kansas,Johnson,137490,129852,22748,78186.0,290090,0.4739563583715399,7638
Kansas,Kearny,1075,174,67,49396.0,1316,0.8168693009118541,901
Kansas,Kingman,2530,599,205,56142.0,3334,0.7588482303539292,1931
Kansas,Kiowa,900,114,65,44896.0,1079,0.8341056533827618,786
Kansas,Labette,5335,2291,481,41851.0,8107,0.6580732700135685,3044
Kansas,Lane,718,106,47,58077.0,871,0.8243398392652124,612
Kansas,Leavenworth,17638,10209,2454,66046.0,30301,0.5820930002310155,7429
Kansas,Lincoln,1179,215,70,49583.0,1464,0.805327868852459,964
Kansas,Linn,3484,736,207,45790.0,4427,0.7869889315563587,2748
Kansas,Logan,1132,149,76,48205.0,1357,0.8341930729550479,983
Kansas,Lyon,6552,4649,1087,40611.0,12288,0.533203125,1903
Kansas,McPherson,8549,3226,967,56783.0,12742,0.670930780097316,5323
Kansas,Marion,4003,1204,417,47926.0,5624,0.7117709815078236,2799
Kansas,Marshall,3307,1072,294,47532.0,4673,0.7076824309865183,2235
Kansas,Meade,1415,210,95,52960.0,1720,0.8226744186046512,1205
Kansas,Miami,10003,3991,1028,63353.0,15022,0.6658900279589934,6012
Kansas,Mitchell,2308,477,157,49755.0,2942,0.7845003399048266,1831
Kansas,Montgomery,8679,2637,688,42646.0,12004,0.7230089970009996,6042
Kansas,Morris,1820,601,203,48551.0,2624,0.6935975609756098,1219
Kansas,Morton,995,147,50,44100.0,1192,0.834731543624161,848
Kansas,Nemaha,4124,725,273,50400.0,5122,0.8051542366263178,3399
Kansas,Neosho,4431,1501,382,43867.0,6314,0.7017738359201774,2930
Kansas,Ness,1228,162,64,47298.0,1454,0.844566712517194,1066
Kansas,Norton,1840,281,113,47651.0,2234,0.8236347358997315,1559
Kansas,Osage,4826,1753,467,52171.0,7046,0.6849276185069543,3073
Kansas,Osborne,1460,233,95,41432.0,1788,0.8165548098434005,1227
Kansas,Ottawa,2283,424,196,52241.0,2903,0.7864278332759215,1859
Kansas,Pawnee,1904,579,178,46227.0,2661,0.7155204810221721,1325
Kansas,Phillips,2233,300,131,45940.0,2664,0.8382132132132132,1933
Kansas,Pottawatomie,7612,2225,856,62500.0,10693,0.71186757691948,5387
Kansas,Pratt,2838,771,233,48995.0,3842,0.7386777719937533,2067
Kansas,Rawlins,1220,163,89,49327.0,1472,0.8288043478260869,1057
Kansas,Reno,15513,6837,1860,46000.0,24210,0.6407682775712515,8676
Kansas,Republic,2024,375,130,41489.0,2529,0.8003163305654409,1649
Kansas,Rice,2837,695,272,46335.0,3804,0.7457939011566772,2142
Kansas,Riley,10107,9341,2084,46609.0,21532,0.4693943897454951,766
Kansas,Rooks,2031,275,113,46750.0,2419,0.8396031417941298,1756
Kansas,Rush,1197,233,73,40395.0,1503,0.7964071856287425,964
Kansas,Russell,2574,461,158,42656.0,3193,0.8061384278108362,2113
Kansas,Saline,13828,6317,1919,48497.0,22064,0.6267222625090645,7511
Kansas,Scott,1865,236,101,61886.0,2202,0.8469573115349682,1629
Kansas,Sedgwick,104353,69627,14803,51157.0,188783,0.5527669334632885,34726
Kansas,Seward,3159,1628,251,47507.0,5038,0.6270345375148869,1531
Kansas,Shawnee,35934,33926,5546,52088.0,75406,0.47654032835583376,2008
Kansas,Sheridan,1197,127,50,50822.0,1374,0.87117903930131,1070
Kansas,Sherman,2089,347,176,47036.0,2612,0.7997702909647779,1742
Kansas,Smith,1661,297,84,43913.0,2042,0.8134182174338883,1364
Kansas,Stafford,1490,304,102,46830.0,1896,0.7858649789029536,1186
Kansas,Stanton,492,115,30,44567.0,637,0.7723704866562009,377
Kansas,Stevens,1599,220,72,54333.0,1891,0.8455843469063987,1379
Kansas,Sumner,6984,2076,662,50950.0,9722,0.7183707056161284,4908
Kansas,Thomas,2908,473,195,52074.0,3576,0.8131991051454138,2435
Kansas,Trego,1227,198,57,54630.0,1482,0.8279352226720648,1029
Kansas,Wabaunsee,2372,776,232,57791.0,3380,0.7017751479289941,1596
Kansas,Wallace,721,46,31,45804.0,798,0.9035087719298246,675
Kansas,Washington,2194,387,184,47045.0,2765,0.7934900542495479,1807
Kansas,Wichita,769,140,47,57596.0,956,0.8043933054393305,629
Kansas,Wilson,2788,594,209,43594.0,3591,0.7763854079643553,2194
Kansas,Woodson,1082,273,88,35321.0,1443,0.7498267498267498,809
Kansas,Wyandotte,15806,30146,2829,40757.0,48781,0.3240195977942232,-14340
Kentucky,Adair,6637,1323,273,33873.0,8233,0.8061459978136767,5314
Kentucky,Allen,6466,1349,281,41166.0,8096,0.7986660079051383,5117
Kentucky,Anderson,8242,2634,546,53513.0,11422,0.7215899142006654,5608
Kentucky,Ballard,3161,816,124,43923.0,4101,0.7707876127773714,2345
Kentucky,Barren,13483,4275,730,39034.0,18488,0.729283859800952,9208
Kentucky,Bath,3082,1361,144,34986.0,4587,0.671898844560715,1721
Kentucky,Bell,7764,1720,234,22603.0,9718,0.7989298209508129,6044
Kentucky,Boone,39082,15026,3510,69165.0,57618,0.6782949772640494,24056
Kentucky,Bourbon,5569,2791,443,44232.0,8803,0.632625241394979,2778
Kentucky,Boyd,13591,6021,842,44140.0,20454,0.6644666079984355,7570
Kentucky,Boyle,8040,4281,625,40758.0,12946,0.6210412482620115,3759
Kentucky,Bracken,2711,705,111,35887.0,3527,0.7686419053019563,2006
Kentucky,Breathitt,3991,1537,210,25484.0,5738,0.6955385151620774,2454
Kentucky,Breckinridge,6484,1960,330,43390.0,8774,0.7390015956234328,4524
Kentucky,Bullitt,26210,8255,1604,58702.0,36069,0.7266627852172225,17955
Kentucky,Butler,4428,947,201,38427.0,5576,0.7941176470588235,3481
Kentucky,Caldwell,4507,1260,208,43491.0,5975,0.7543096234309623,3247
Kentucky,Calloway,10367,4749,933,36692.0,16049,0.6459592497974952,5618
Kentucky,Campbell,25050,14658,2802,56772.0,42510,0.589273112208892,10392
Kentucky,Carlisle,2094,432,75,40913.0,2601,0.8050749711649365,1662
Kentucky,Carroll,2588,1106,161,42882.0,3855,0.6713359273670557,1482
Kentucky,Carter,7587,2276,415,37367.0,10278,0.7381786339754816,5311
Kentucky,Casey,5482,767,190,32315.0,6439,0.8513744370243826,4715
Kentucky,Christian,14108,7188,787,40253.0,22083,0.6388624733958248,6920
Kentucky,Clark,10710,4706,789,49069.0,16205,0.6609071274298056,6004
Kentucky,Clay,5861,752,154,22174.0,6767,0.8661149697059258,5109
Kentucky,Clinton,3809,547,106,29872.0,4462,0.8536530703720305,3262
Kentucky,Crittenden,3290,617,130,38739.0,4037,0.8149616051523408,2673
Kentucky,Cumberland,2502,459,105,33268.0,3066,0.8160469667318982,2043
Kentucky,Daviess,28907,14163,2737,46675.0,45807,0.6310607549064553,14744
Kentucky,Edmonson,4135,979,130,41689.0,5244,0.7885202135774219,3156
Kentucky,Elliott,2000,740,115,27969.0,2855,0.7005253940455342,1260
Kentucky,Estill,4236,1108,201,29694.0,5545,0.763931469792606,3128
Kentucky,Fayette,56894,69778,9643,50661.0,136315,0.41737152917874043,-12884
Kentucky,Fleming,4722,1348,190,36063.0,6260,0.7543130990415335,3374
Kentucky,Floyd,11993,4015,532,30540.0,16540,0.7250906892382104,7978
Kentucky,Franklin,11819,10717,1329,50999.0,23865,0.49524408129059294,1102
Kentucky,Fulton,1549,774,59,26841.0,2382,0.6502938706968934,775
Kentucky,Gallatin,2443,749,146,51180.0,3338,0.7318753744757339,1694
Kentucky,Garrard,5904,1453,266,46373.0,7623,0.7744982290436836,4451
Kentucky,Grant,7268,1910,381,44191.0,9559,0.7603305785123967,5358
Kentucky,Graves,12671,3308,627,40268.0,16606,0.7630374563410816,9363
Kentucky,Grayson,8219,1959,398,36129.0,10576,0.7771369137670197,6260
Kentucky,Green,4372,832,129,36681.0,5333,0.8198012375773486,3540
Kentucky,Greenup,11546,4146,585,46771.0,16277,0.7093444737973829,7400
Kentucky,Hancock,2788,1244,263,49375.0,4295,0.649126891734575,1544
Kentucky,Hardin,26971,13944,2241,51541.0,43156,0.6249652423764945,13027
Kentucky,Harlan,9129,1372,256,25350.0,10757,0.8486566886678442,7757
Kentucky,Harrison,5435,2031,315,40164.0,7781,0.6984963372317183,3404
Kentucky,Hart,5320,1730,214,35738.0,7264,0.7323788546255506,3590
Kentucky,Henderson,12159,6707,844,41630.0,19710,0.6168949771689498,5452
Kentucky,Henry,4944,1828,377,50412.0,7149,0.6915652538816618,3116
Kentucky,Hickman,1657,449,51,39756.0,2157,0.7681965693092258,1208
Kentucky,Hopkins,15277,4310,758,43169.0,20345,0.7508970262963873,10967
Kentucky,Jackson,4889,482,130,30884.0,5501,0.8887475004544628,4407
Kentucky,Jefferson,143768,190836,18495,50099.0,353099,0.4071605980192524,-47068
Kentucky,Jessamine,15474,6144,1708,52748.0,23326,0.663379919403241,9330
Kentucky,Johnson,8043,1250,279,35060.0,9572,0.8402632678646051,6793
Kentucky,Kenton,42958,24214,4826,56568.0,71998,0.5966554626517403,18744
Kentucky,Knott,4357,1245,161,28165.0,5763,0.7560298455665452,3112
Kentucky,Knox,9885,1761,366,26553.0,12012,0.8229270729270729,8124
Kentucky,Larue,4799,1278,290,41050.0,6367,0.7537301711952253,3521
Kentucky,Laurel,20592,3440,801,36139.0,24833,0.8292191841501229,17152
Kentucky,Lawrence,4816,1045,181,35016.0,6042,0.797087057265806,3771
Kentucky,Lee,2151,444,72,21185.0,2667,0.8065241844769404,1707
Kentucky,Leslie,4015,400,77,25282.0,4492,0.8938112199465716,3615
Kentucky,Letcher,7293,1542,299,29181.0,9134,0.7984453689511715,5751
Kentucky,Lewis,4363,785,150,29088.0,5298,0.823518308795772,3578
Kentucky,Lincoln,7338,1865,358,35185.0,9561,0.7674929400690305,5473
Kentucky,Livingston,3570,887,188,43333.0,4645,0.7685683530678149,2683
Kentucky,Logan,7778,2755,366,39027.0,10899,0.7136434535278466,5023
Kentucky,Lyon,2789,1045,128,47861.0,3962,0.7039374053508329,1744
Kentucky,McCracken,20774,9134,1399,42303.0,31307,0.6635576708084454,11640
Kentucky,McCreary,5012,664,100,18972.0,5776,0.8677285318559557,4348
Kentucky,McLean,3381,988,197,43005.0,4566,0.740473061760841,2393
Kentucky,Madison,23431,11793,2147,43707.0,37371,0.6269834898718257,11638
Kentucky,Magoffin,3824,1172,120,29463.0,5116,0.7474589523064894,2652
Kentucky,Marion,5122,2679,310,40392.0,8111,0.6314881025767476,2443
Kentucky,Marshall,12322,3672,704,45670.0,16698,0.7379326865492873,8650
Kentucky,Martin,3503,363,87,29052.0,3953,0.8861624082974956,3140
Kentucky,Mason,4944,1970,305,38613.0,7219,0.6848593988086993,2974
Kentucky,Meade,8660,3026,545,50034.0,12231,0.7080369552775734,5634
Kentucky,Menifee,2010,700,69,35280.0,2779,0.723281756027348,1310
Kentucky,Mercer,7740,2395,450,46130.0,10585,0.7312234293811998,5345
Kentucky,Metcalfe,3491,976,153,33788.0,4620,0.7556277056277056,2515
Kentucky,Monroe,4278,601,112,34120.0,4991,0.8571428571428571,3677
Kentucky,Montgomery,7856,3158,438,39750.0,11452,0.6859937128885785,4698
Kentucky,Morgan,3628,1006,141,32517.0,4775,0.7597905759162303,2622
Kentucky,Muhlenberg,9393,3272,395,40445.0,13060,0.719218989280245,6121
Kentucky,Nelson,13431,6434,937,51408.0,20802,0.6456590712431497,6997
Kentucky,Nicholas,1957,787,97,37993.0,2841,0.6888419570573742,1170
Kentucky,Ohio,7942,2080,376,39479.0,10398,0.7638007309097904,5862
Kentucky,Oldham,20469,10268,2116,86324.0,32853,0.6230481234590448,10201
Kentucky,Owen,3745,1062,194,41597.0,5001,0.7488502299540092,2683
Kentucky,Owsley,1474,256,29,22106.0,1759,0.8379761227970438,1218
Kentucky,Pendleton,4604,1164,239,49766.0,6007,0.76643915431996,3440
Kentucky,Perry,8158,2136,278,31578.0,10572,0.7716609912977677,6022
Kentucky,Pike,19747,4280,638,32816.0,24665,0.8006081491992703,15467
Kentucky,Powell,3513,1272,172,34048.0,4957,0.7086947750655639,2241
Kentucky,Pulaski,22902,4208,931,34673.0,28041,0.8167326414892478,18694
Kentucky,Robertson,759,222,32,30964.0,1013,0.7492596248766041,537
Kentucky,Rockcastle,5609,915,167,33500.0,6691,0.8382902406217306,4694
Kentucky,Rowan,5174,3295,379,36216.0,8848,0.5847649186256781,1879
Kentucky,Russell,6863,1093,218,31539.0,8174,0.8396134083679961,5770
Kentucky,Scott,15052,7715,1433,64329.0,24200,0.6219834710743801,7337
Kentucky,Shelby,13196,6276,1108,61737.0,20580,0.6412050534499514,6920
Kentucky,Simpson,5077,2144,310,42288.0,7531,0.6741468596467932,2933
Kentucky,Spencer,7196,1921,398,65700.0,9515,0.7562795585916973,5275
Kentucky,Taylor,8320,2553,433,32977.0,11306,0.7358924464885901,5767
Kentucky,Todd,3612,1042,125,41306.0,4779,0.7558066541117389,2570
Kentucky,Trigg,4931,1587,233,45032.0,6751,0.7304103095837654,3344
Kentucky,Trimble,2771,879,148,45935.0,3798,0.729594523433386,1892
Kentucky,Union,4701,1331,179,41255.0,6211,0.7568829496055386,3370
Kentucky,Warren,28673,16966,2815,46929.0,48454,0.5917571304742643,11707
Kentucky,Washington,4013,1420,203,43719.0,5636,0.7120298083747338,2593
Kentucky,Wayne,6371,1431,190,30260.0,7992,0.7971721721721722,4940
Kentucky,Webster,4397,1240,168,38374.0,5805,0.7574504737295435,3157
Kentucky,Whitley,11312,2067,395,32397.0,13774,0.8212574415565558,9245
Kentucky,Wolfe,1804,753,78,21797.0,2635,0.6846299810246679,1051
Kentucky,Woodford,7697,4958,908,59471.0,13563,0.5674998156749982,2739
Louisiana,Acadia,21162,5638,589,39837.0,27389,0.7726459527547556,15524
Louisiana,Allen,6867,2106,272,41801.0,9245,0.7427798810167658,4761
Louisiana,Ascension,36143,16476,2059,71752.0,54678,0.6610153992464977,19667
Louisiana,Assumption,6714,3931,259,47822.0,10904,0.6157373440939105,2783
Louisiana,Avoyelles,11165,5035,386,34985.0,16586,0.6731580851320391,6130
Louisiana,Beauregard,12238,2393,447,46599.0,15078,0.8116461069107309,9845
Louisiana,Bienville,3756,3129,120,35722.0,7005,0.5361884368308352,627
Louisiana,Bossier,35474,12641,1733,51894.0,49848,0.7116433959236078,22833
Louisiana,Caddo,49006,53483,3315,40815.0,105804,0.46317719556916565,-4477
Louisiana,Calcasieu,54191,26296,3298,46457.0,83785,0.6467864176165184,27895
Louisiana,Caldwell,3822,788,82,29832.0,4692,0.8145780051150895,3034
Louisiana,Cameron,3256,323,113,65679.0,3692,0.8819068255687974,2933
Louisiana,Catahoula,3479,1322,55,34736.0,4856,0.7164332784184514,2157
Louisiana,Claiborne,3585,2717,119,28927.0,6421,0.5583242485594144,868
Louisiana,Concordia,5477,3272,123,28405.0,8872,0.6173354373309288,2205
Louisiana,De Soto,8068,5165,267,42368.0,13500,0.5976296296296296,2903
Louisiana,East Baton Rouge,84660,102828,9003,49942.0,196491,0.4308594286761226,-18168
Louisiana,East Carroll,1059,1838,42,22093.0,2939,0.360326641714869,-779
Louisiana,East Feliciana,5569,4235,238,48997.0,10042,0.5545708026289584,1334
Louisiana,Evangeline,10360,4208,314,30724.0,14882,0.6961429915333961,6152
Louisiana,Franklin,6514,2506,142,32440.0,9162,0.7109801353416285,4008
Louisiana,Grant,7408,1181,232,40389.0,8821,0.8398140800362771,6227
Louisiana,Iberia,20903,10698,853,44573.0,32454,0.6440808528994885,10205
Louisiana,Iberville,7320,8324,399,46480.0,16043,0.45627376425855515,-1004
Louisiana,Jackson,5169,2139,156,38310.0,7464,0.692524115755627,3030
Louisiana,Jefferson,100398,73670,7571,49457.0,181639,0.5527337190801535,26728
Louisiana,Jefferson Davis,10775,3080,422,39202.0,14277,0.7547103733277299,7695
Louisiana,Lafayette,68195,32726,4682,52435.0,105603,0.6457676391769174,35469
Louisiana,Lafourche,31959,8423,1263,52071.0,41645,0.7674150558290311,23536
Louisiana,La Salle,5836,605,128,35339.0,6569,0.8884152839092708,5231
Louisiana,Lincoln,10761,7107,801,34527.0,18669,0.5764100915956933,3654
Louisiana,Livingston,48824,6950,1956,57334.0,57730,0.8457301229863156,41874
Louisiana,Madison,1927,2744,61,25404.0,4732,0.4072273879966188,-817
Louisiana,Morehouse,6502,5155,195,30279.0,11852,0.5485993925075937,1347
Louisiana,Natchitoches,8968,7144,509,30697.0,16621,0.5395583899885686,1824
Louisiana,Orleans,24292,133996,7524,37488.0,165812,0.14650326876221262,-109704
Louisiana,Ouachita,41734,24428,1855,38974.0,68017,0.6135818986429863,17306
Louisiana,Plaquemines,6900,3347,326,50251.0,10573,0.6526056937482266,3553
Louisiana,Pointe Coupee,6789,4764,208,44275.0,11761,0.577246832752317,2025
Louisiana,Rapides,36816,18322,1706,42132.0,56844,0.6476672999788896,18494
Louisiana,Red River,2391,1938,93,36831.0,4422,0.5407055630936228,453
Louisiana,Richland,6287,3157,153,35684.0,9597,0.6551005522559133,3130
Louisiana,Sabine,7879,1703,205,39372.0,9787,0.8050475120057219,6176
Louisiana,St. Bernard,10237,4960,618,43565.0,15815,0.6472968700600695,5277
Louisiana,St. Charles,16621,8559,1012,61691.0,26192,0.6345830788026878,8062
Louisiana,St. Helena,2497,3353,114,36418.0,5964,0.4186787391012743,-856
Louisiana,St. James,5456,6418,211,51386.0,12085,0.45146876292925114,-962
Louisiana,St. John the Baptist,7569,12661,513,51406.0,20743,0.3648941811695512,-5092
Louisiana,St. Landry,21971,17209,797,31424.0,39977,0.5495910148335292,4762
Louisiana,St. Martin,16873,8266,611,46450.0,25750,0.6552621359223301,8607
Louisiana,St. Mary,14359,8050,468,40771.0,22877,0.6276609695327184,6309
Louisiana,St. Tammany,90915,27717,5760,63686.0,124392,0.7308749758826935,63198
Louisiana,Tangipahoa,33959,16878,1579,43690.0,52416,0.6478746947496947,17081
Louisiana,Tensas,1182,1332,34,22385.0,2548,0.4638932496075353,-150
Louisiana,Terrebonne,31902,10665,1329,48166.0,43896,0.726763258611263,21237
Louisiana,Union,7972,2691,231,37049.0,10894,0.731778960895906,5281
Louisiana,Vermilion,20063,4857,712,47083.0,25632,0.7827325218476904,15206
Louisiana,Vernon,13471,2665,497,46561.0,16633,0.8098959898995972,10806
Louisiana,Washington,12556,5692,380,31013.0,18628,0.6740390809534035,6864
Louisiana,Webster,11542,6260,343,31920.0,18145,0.6360980986497657,5282
Louisiana,West Baton Rouge,6927,5383,402,53882.0,12712,0.544918187539333,1544
Louisiana,West Carroll,3970,715,74,36670.0,4759,0.8342088674091196,3255
Louisiana,West Feliciana,3390,2248,161,53364.0,5799,0.5845835488877392,1142
Louisiana,Winn,4608,1644,120,32063.0,6372,0.7231638418079096,2964
Maine,Androscoggin,28227,23009,4365,48728.0,55601,0.5076707253466665,5218
Maine,Aroostook,19419,13386,2292,38087.0,35097,0.5532951534319173,6033
Maine,Cumberland,57709,102981,11128,61902.0,171818,0.3358728421934838,-45272
Maine,Franklin,7918,7016,1554,43007.0,16488,0.480228044638525,902
Maine,Hancock,13705,16117,2308,50037.0,32130,0.42654839713663245,-2412
Maine,Kennebec,31675,29302,5231,48570.0,66208,0.4784165055582407,2373
Maine,Knox,9148,12443,1556,52239.0,23147,0.3952132025748477,-3295
Maine,Lincoln,9727,10241,1535,53515.0,21503,0.45235548528112357,-514
Maine,Oxford,16210,12172,2819,42197.0,31201,0.5195346303003109,4038
Maine,Penobscot,41622,32838,6080,45302.0,80540,0.516786689843556,8784
Maine,Piscataquis,5406,3098,678,36938.0,9182,0.5887606186016119,2308
Maine,Sagadahoc,9304,10664,1648,55766.0,21616,0.4304219096965211,-1360
Maine,Somerset,15001,9092,1971,40484.0,26064,0.5755448127685697,5909
Maine,Waldo,10378,10440,1889,45480.0,22707,0.45703967939401946,-62
Maine,Washington,9093,6075,1197,39469.0,16365,0.5556370302474793,3018
Maine,York,50403,55844,8027,59132.0,114274,0.44107145982463203,-5441
Maryland,Allegany,21270,7875,1509,41559.0,30654,0.6938735564689763,13395
Maryland,Anne Arundel,122403,128419,19259,91918.0,270081,0.4532084818998745,-6016
Maryland,Baltimore,149477,218412,22793,68989.0,390682,0.3826052902360488,-68935
Maryland,Calvert,26176,18225,3007,96808.0,47408,0.5521430982112724,7951
Maryland,Caroline,9368,4009,736,50830.0,14113,0.6637851626160278,5359
Maryland,Carroll,58215,26567,7066,87060.0,91848,0.6338189182126992,31648
Maryland,Cecil,28868,13650,2751,67938.0,45269,0.637699087675893,15218
Maryland,Charles,25614,49341,3348,91373.0,78303,0.3271139036818513,-23727
Maryland,Dorchester,8413,6245,567,47907.0,15225,0.5525779967159278,2168
Maryland,Frederick,59522,56522,9633,85715.0,125677,0.4736109232397336,3000
Maryland,Garrett,10776,2567,668,46277.0,14011,0.7691099850117764,8209
Maryland,Harford,77860,47077,8735,81052.0,133672,0.5824705248668383,30783
Maryland,Howard,47484,102597,12112,113800.0,162193,0.29276232636426974,-55113
Maryland,Kent,4876,4575,570,55028.0,10021,0.48657818580979945,301
Maryland,Montgomery,92704,357837,28332,100352.0,478873,0.1935878614998131,-265133
Maryland,Prince George's,32811,344049,13525,75925.0,390385,0.08404779896768574,-311238
Maryland,Queen Anne's,16993,7973,1557,85891.0,26523,0.640689213135769,9020
Maryland,St. Mary's,28663,17534,3645,86810.0,49842,0.5750772440913285,11129
Maryland,Somerset,5341,4196,363,35886.0,9900,0.5394949494949495,1145
Maryland,Talbot,10724,8653,1176,61395.0,20553,0.5217729771809468,2071
Maryland,Washington,40998,21129,3864,56316.0,65991,0.6212665363458654,19869
Maryland,Wicomico,22198,18050,2299,53508.0,42547,0.5217289115566315,4148
Maryland,Worcester,17210,9753,1310,57227.0,28273,0.6087079545856471,7457
Maryland,Baltimore City,25205,202673,11524,44262.0,239402,0.10528316388334266,-177468
Massachusetts,Barnstable,54099,72430,7333,65382.0,133862,0.40414008456470096,-18331
Massachusetts,Berkshire,16839,43714,4250,52253.0,64803,0.25984908106106197,-26875
Massachusetts,Bristol,105443,129540,13976,59343.0,248959,0.42353560224775966,-24097
Massachusetts,Dukes,2477,8400,625,63534.0,11502,0.21535385150408626,-5923
Massachusetts,Essex,136316,222310,21242,70886.0,379868,0.3588509692840671,-85994
Massachusetts,Franklin,10364,24478,3335,56347.0,38177,0.27147235246352514,-14114
Massachusetts,Hampden,78685,112590,11842,51005.0,203117,0.3873875648025522,-33905
Massachusetts,Hampshire,21790,55367,5799,62608.0,82956,0.26266936689329284,-33577
Massachusetts,Middlesex,219793,520360,43881,89019.0,784034,0.2803360568546772,-300567
Massachusetts,Nantucket,1892,4146,368,89428.0,6406,0.2953481111458008,-2254
Massachusetts,Norfolk,119723,221819,20020,90226.0,361562,0.33112716491224187,-102096
Massachusetts,Plymouth,115369,135513,15981,77627.0,266863,0.4323154577442358,-20144
Massachusetts,Suffolk,50421,245751,12569,57439.0,308741,0.16331164309243024,-195330
Massachusetts,Worcester,157682,198778,27245,67005.0,383705,0.4109459089665238,-41096
Michigan,Alcona,4201,1732,265,38160.0,6198,0.6777992900935785,2469
Michigan,Alger,2585,1663,270,41270.0,4518,0.5721558211598052,922
Michigan,Allegan,34183,18050,3553,55630.0,55786,0.6127523034453088,16133
Michigan,Alpena,9090,4877,731,39832.0,14698,0.6184514899986393,4213
Michigan,Antrim,8469,4448,665,48825.0,13582,0.6235458695332057,4021
Michigan,Arenac,4950,2384,362,39240.0,7696,0.6431912681912682,2566
Michigan,Baraga,2158,1156,176,42810.0,3490,0.6183381088825215,1002
Michigan,Barry,19202,9114,2013,56883.0,30329,0.6331234132348578,10088
Michigan,Bay,28328,21642,3007,45851.0,52977,0.53472261547464,6686
Michigan,Benzie,5539,4108,581,48694.0,10228,0.54155260070395,1431
Michigan,Berrien,38647,29495,3889,45980.0,72031,0.536532881675945,9152
Michigan,Branch,11786,5061,816,46428.0,17663,0.6672705655890845,6725
Michigan,Calhoun,31494,24157,3251,44681.0,58902,0.5346847305694203,7337
Michigan,Cass,14243,7270,1082,47991.0,22595,0.6303606992697499,6973
Michigan,Charlevoix,8674,5137,778,48603.0,14589,0.5945575433545822,3537
Michigan,Cheboygan,8683,4302,687,41023.0,13672,0.6350936220011703,4381
Michigan,Chippewa,9122,5379,955,42287.0,15456,0.5901915113871635,3743
Michigan,Clare,8505,4249,635,34911.0,13389,0.6352229442079319,4256
Michigan,Clinton,21636,16492,2527,62646.0,40655,0.5321854630426762,5144
Michigan,Crawford,4354,2110,380,41034.0,6844,0.636177673874927,2244
Michigan,Delta,11121,6436,935,42353.0,18492,0.6013951979234263,4685
Michigan,Dickinson,8580,3923,662,43373.0,13165,0.6517280668439043,4657
Michigan,Eaton,27609,24938,3674,56472.0,56221,0.4910798456092919,2671
Michigan,Emmet,10616,6972,1214,51096.0,18802,0.5646207850228699,3644
Michigan,Genesee,84175,102751,9370,43246.0,196296,0.428816685006317,-18576
Michigan,Gladwin,8124,3794,554,39629.0,12472,0.6513790891597178,4330
Michigan,Gogebic,4018,2925,386,35833.0,7329,0.5482330468003821,1093
Michigan,Grand Traverse,27413,20965,3211,55597.0,51589,0.5313729671053907,6448
Michigan,Gratiot,9880,5666,919,42145.0,16465,0.6000607348921956,4214
Michigan,Hillsdale,14095,4799,1046,44458.0,19940,0.7068706118355065,9296
Michigan,Houghton,8475,6018,1131,39080.0,15624,0.5424347158218126,2457
Michigan,Huron,10692,4579,646,43082.0,15917,0.6717346233586731,6113
Michigan,Ingham,43868,79110,8160,46842.0,131138,0.3345178361725816,-35242
Michigan,Ionia,16635,8352,1867,50037.0,26854,0.6194607879645491,8283
Michigan,Iosco,8345,4345,671,38900.0,13361,0.6245789985779507,4000
Michigan,Iron,3675,2004,231,33137.0,5910,0.6218274111675127,1671
Michigan,Isabella,12338,11404,1650,40706.0,25392,0.48590107120352866,934
Michigan,Jackson,39793,25795,4089,47709.0,69677,0.5711066779568581,13998
Michigan,Kalamazoo,51034,67148,8117,49693.0,126299,0.4040728746862604,-16114
Michigan,Kalkaska,6116,2280,437,42612.0,8833,0.6924034869240349,3836
Michigan,Kent,148180,138683,21321,54673.0,308184,0.48081665498533344,9497
Michigan,Keweenaw,814,527,93,41472.0,1434,0.5676429567642957,287
Michigan,Lake,3159,1939,230,30824.0,5328,0.5929054054054054,1220
Michigan,Lapeer,30037,12734,2412,54174.0,45183,0.6647854281477547,17303
Michigan,Leelanau,7239,6774,744,59018.0,14757,0.49054685911770685,465
Michigan,Lenawee,26430,16750,2759,49300.0,45939,0.5753281525501208,9680
Michigan,Livingston,65680,34384,5802,76764.0,105866,0.6204069295146695,31296
Michigan,Luce,1756,681,142,38167.0,2579,0.680884063590539,1075
Michigan,Mackinac,3744,2085,268,40747.0,6097,0.6140724946695096,1659
Michigan,Macomb,224665,176317,18330,55951.0,419312,0.5357943488380967,48348
Michigan,Manistee,6915,4979,705,42530.0,12599,0.5488530835780617,1936
Michigan,Marquette,14646,16042,2288,46822.0,32976,0.44414119359534204,-1396
Michigan,Mason,8505,5281,899,43497.0,14685,0.5791624106230848,3224
Michigan,Mecosta,10305,5827,1036,41827.0,17168,0.6002446411929171,4478
Michigan,Menominee,6702,3539,527,41235.0,10768,0.6223997028231798,3163
Michigan,Midland,23846,15635,3025,54852.0,42506,0.5610031524961182,8211
Michigan,Missaukee,5386,1565,366,42077.0,7317,0.7360940276069428,3821
Michigan,Monroe,43261,26863,4094,56968.0,74218,0.5828909428979493,16398
Michigan,Montcalm,16907,7874,1828,43126.0,26609,0.6353865233567589,9033
Michigan,Montmorency,3498,1287,224,37145.0,5009,0.6983429826312637,2211
Michigan,Muskegon,36127,37304,4657,43920.0,78088,0.46264470853396167,-1177
Michigan,Newaygo,15173,6212,1255,44049.0,22640,0.6701855123674911,8961
Michigan,Oakland,289203,343070,32341,69850.0,664614,0.4351443093284222,-53867
Michigan,Oceana,7228,3973,729,41952.0,11930,0.6058675607711651,3255
Michigan,Ogemaw,6827,3030,530,36941.0,10387,0.6572638875517474,3797
Michigan,Ontonagon,2066,1176,184,35038.0,3426,0.603035610040864,890
Michigan,Osceola,7336,2705,568,39247.0,10609,0.6914883589405222,4631
Michigan,Oscoda,2843,1044,186,35175.0,4073,0.6980112938865701,1799
Michigan,Otsego,8266,3556,716,50793.0,12538,0.6592758015632477,4710
Michigan,Ottawa,88467,44973,9294,61367.0,142734,0.6198032704191012,43494
Michigan,Presque Isle,4488,2400,330,41570.0,7218,0.6217788861180382,2088
Michigan,Roscommon,8141,4287,613,35959.0,13041,0.6242619431025228,3854
Michigan,Saginaw,45469,44396,4455,43712.0,94320,0.48207167090754877,1073
Michigan,St. Clair,49051,24553,4399,50930.0,78003,0.6288347884055742,24498
Michigan,St. Joseph,14884,7526,1347,45410.0,23757,0.6265100812392137,7358
Michigan,Sanilac,13446,4873,930,42037.0,19249,0.6985297937555197,8573
Michigan,Schoolcraft,2556,1369,229,36649.0,4154,0.6153105440539239,1187
Michigan,Shiawassee,19230,12546,2335,48470.0,34111,0.5637477646506992,6684
Michigan,Tuscola,17102,7429,1265,44193.0,25796,0.6629710032563189,9673
Michigan,Van Buren,17890,13258,2126,47141.0,33274,0.5376570295125324,4632
Michigan,Washtenaw,50631,128483,9464,62484.0,188578,0.26848837085980337,-77852
Michigan,Wayne,228993,519444,29401,42043.0,777838,0.2943967767067179,-290451
Michigan,Wexford,10000,4436,862,40417.0,15298,0.6536802196365538,5564
Minnesota,Aitkin,5516,3134,581,44524.0,9231,0.5975517278734699,2382
Minnesota,Anoka,93339,75500,16919,73579.0,185758,0.5024763401845411,17839
Minnesota,Becker,10880,5208,1134,54115.0,17222,0.631750087097898,5672
Minnesota,Beltrami,10783,8688,2093,45201.0,21564,0.5000463735856057,2095
Minnesota,Benton,12872,5640,1546,51841.0,20058,0.6417389570246286,7232
Minnesota,Big Stone,1608,921,226,47132.0,2755,0.5836660617059891,687
Minnesota,Blue Earth,15667,14428,3498,52119.0,33593,0.4663769237638794,1239
Minnesota,Brown,8708,3763,1308,53319.0,13779,0.6319761956600625,4945
Minnesota,Carlton,8160,8460,1591,55607.0,18211,0.4480808302674208,-300
Minnesota,Carver,29056,21508,5132,88638.0,55696,0.5216891697787992,7548
Minnesota,Cass,9982,4949,1068,47926.0,15999,0.623913994624664,5033
Minnesota,Chippewa,3764,1978,480,54041.0,6222,0.6049501767920283,1786
Minnesota,Chisago,18441,9278,2509,72908.0,30228,0.6100635172687574,9163
Minnesota,Clay,13543,12971,2884,59614.0,29398,0.46067759711545003,572
Minnesota,Clearwater,2925,1100,220,44203.0,4245,0.6890459363957597,1825
Minnesota,Cook,1156,1912,327,51793.0,3395,0.34050073637702505,-756
Minnesota,Cottonwood,3679,1678,364,47407.0,5721,0.6430693934626813,2001
Minnesota,Crow Wing,22287,10982,2573,50893.0,35842,0.6218123988616706,11305
Minnesota,Dakota,99583,110483,21374,77321.0,231440,0.43027566539923956,-10900
Minnesota,Dodge,6527,3102,1025,68718.0,10654,0.6126337525811901,3425
Minnesota,Douglas,13966,6227,1592,56347.0,21785,0.6410833142070231,7739
Minnesota,Faribault,4659,2153,600,49101.0,7412,0.6285752833243389,2506
Minnesota,Fillmore,6271,3872,912,54358.0,11055,0.5672546359113523,2399
Minnesota,Freeborn,8808,6041,1202,48827.0,16051,0.5487508566444458,2767
Minnesota,Goodhue,14041,9446,2230,60452.0,25717,0.545981257533927,4595
Minnesota,Grant,2063,1105,305,53828.0,3473,0.594010941549093,958
Minnesota,Hennepin,191770,429288,58919,67989.0,679977,0.2820242449376964,-237518
Minnesota,Houston,5616,4145,843,55550.0,10604,0.5296114673708034,1471
Minnesota,Hubbard,7261,3423,821,49742.0,11505,0.6311169056931769,3838
Minnesota,Isanti,13635,5657,1724,62733.0,21016,0.6487913970308337,7978
Minnesota,Itasca,12920,9015,1945,49507.0,23880,0.541038525963149,3905
Minnesota,Jackson,3609,1492,383,55114.0,5484,0.6580962800875274,2117
Minnesota,Kanabec,5230,2327,620,48042.0,8177,0.6395988748929925,2903
Minnesota,Kandiyohi,12785,7266,1721,53514.0,21772,0.5872221201543266,5519
Minnesota,Kittson,1349,823,213,51484.0,2385,0.5656184486373166,526
Minnesota,Koochiching,3569,2306,488,44929.0,6363,0.5608989470375609,1263
Minnesota,Lac Qui Parle,2293,1305,262,49210.0,3860,0.594041450777202,988
Minnesota,Lake,2932,3077,512,52320.0,6521,0.449624290752952,-145
Minnesota,Lake of the Woods,1540,553,149,45732.0,2242,0.6868867082961642,987
Minnesota,Le Sueur,9182,4623,1166,62462.0,14971,0.6133190835615523,4559
Minnesota,Lincoln,1931,860,228,49438.0,3019,0.639615766810202,1071
Minnesota,Lyon,7256,3825,1134,51920.0,12215,0.5940237413016782,3431
Minnesota,McLeod,12155,4978,1674,57738.0,18807,0.646301908863721,7177
Minnesota,Mahnomen,991,930,167,41597.0,2088,0.4746168582375479,61
Minnesota,Marshall,3208,1225,384,56340.0,4817,0.6659746730330081,1983
Minnesota,Martin,7062,2733,736,51984.0,10531,0.670591586743899,4329
Minnesota,Meeker,8104,3191,987,58574.0,12282,0.6598273896759486,4913
Minnesota,Mille Lacs,8340,3710,967,51232.0,13017,0.6407006222631942,4630
Minnesota,Morrison,12925,3637,1052,51456.0,17614,0.7337913023731123,9288
Minnesota,Mower,8823,7437,1455,51778.0,17715,0.49805249788314987,1386
Minnesota,Murray,2974,1295,399,51801.0,4668,0.6371036846615252,1679
Minnesota,Nicollet,8437,7886,1774,61501.0,18097,0.46620986903906725,551
Minnesota,Nobles,5299,2733,600,53269.0,8632,0.6138785912882299,2566
Minnesota,Norman,1699,1264,298,52083.0,3261,0.5210058264336094,435
Minnesota,Olmsted,35668,36268,8193,69308.0,80129,0.44513222428833504,-600
Minnesota,Otter Tail,20939,9340,2221,53351.0,32500,0.6442769230769231,11599
Minnesota,Pennington,4000,2147,568,51156.0,6715,0.5956813104988831,1853
Minnesota,Pine,8191,4580,1040,45379.0,13811,0.5930779813192383,3611
Minnesota,Pipestone,3338,1127,343,48944.0,4808,0.6942595673876872,2211
Minnesota,Polk,8979,4712,1105,53059.0,14796,0.606853203568532,4267
Minnesota,Pope,3793,2106,420,55180.0,6319,0.6002532046209843,1687
Minnesota,Ramsey,70894,177738,24511,57717.0,273143,0.259549027432517,-106844
Minnesota,Red Lake,1141,540,200,49800.0,1881,0.6065922381711856,601
Minnesota,Redwood,5137,1887,587,48891.0,7611,0.6749441597687558,3250
Minnesota,Renville,4890,2117,599,54824.0,7606,0.6429134893505127,2773
Minnesota,Rice,15429,14437,2577,61683.0,32443,0.47557254261319853,992
Minnesota,Rock,3091,1373,375,52835.0,4839,0.6387683405662327,1718
Minnesota,Roseau,5451,1856,497,54827.0,7804,0.6984879548949257,3595
Minnesota,Saint Louis,44630,57771,10021,49395.0,112422,0.39698635498389995,-13141
Minnesota,Scott,39948,28502,6579,90198.0,75029,0.5324341254714844,11446
Minnesota,Sherburne,31053,13293,3937,78081.0,48283,0.6431456206118096,17760
Minnesota,Sibley,5193,1954,627,59596.0,7774,0.6679958837149472,3239
Minnesota,Stearns,47617,25576,6399,56977.0,79592,0.5982636445873957,22041
Minnesota,Steele,11198,6241,1740,58141.0,19179,0.583867772042338,4957
Minnesota,Stevens,2799,2116,483,55941.0,5398,0.5185253797702853,683
Minnesota,Swift,2963,1686,345,49956.0,4994,0.5933119743692431,1277
Minnesota,Todd,8485,2783,725,47549.0,11993,0.7074960393562911,5702
Minnesota,Traverse,1049,630,119,50333.0,1798,0.5834260289210234,419
Minnesota,Wabasha,6989,3866,977,58865.0,11832,0.5906862745098039,3123
Minnesota,Wadena,4837,1684,413,42689.0,6934,0.6975771560426882,3153
Minnesota,Waseca,5967,2838,848,53199.0,9653,0.618149797990262,3129
Minnesota,Washington,64428,67086,12721,86689.0,144235,0.4466876971608833,-2658
Minnesota,Watonwan,2768,1814,416,50068.0,4998,0.5538215286114446,954
Minnesota,Wilkin,2129,893,280,52963.0,3302,0.6447607510599637,1236
Minnesota,Winona,12122,11366,2586,52840.0,26074,0.4649075707601442,756
Minnesota,Wright,43274,20334,6010,75705.0,69618,0.6215921169812405,22940
Minnesota,Yellow Medicine,3382,1524,370,54717.0,5276,0.6410159211523881,1858
Mississippi,Adams,5874,7757,205,31283.0,13836,0.42454466608846486,-1883
Mississippi,Alcorn,11819,2684,280,38892.0,14783,0.7994994250152202,9135
Mississippi,Amite,4289,2697,64,27334.0,7050,0.6083687943262411,1592
Mississippi,Attala,4897,3242,117,33018.0,8256,0.5931443798449613,1655
Mississippi,Benton,2251,1719,43,36302.0,4013,0.5609269872913033,532
Mississippi,Bolivar,4590,9046,188,27457.0,13824,0.33203125,-4456
Mississippi,Calhoun,4390,1910,96,31141.0,6396,0.6863664790494058,2480
Mississippi,Carroll,3799,1680,49,40278.0,5528,0.6872286541244573,2119
Mississippi,Chickasaw,4127,3649,114,31048.0,7890,0.5230671736375159,478
Mississippi,Choctaw,2788,1218,59,32953.0,4065,0.6858548585485855,1570
Mississippi,Claiborne,540,3708,24,25000.0,4272,0.12640449438202248,-3168
Mississippi,Clarke,5137,2585,69,36441.0,7791,0.6593505326658965,2552
Mississippi,Clay,4150,5722,131,33142.0,10003,0.41487553733879834,-1572
Mississippi,Coahoma,2426,6378,108,28217.0,8912,0.2722172351885099,-3952
Mississippi,Copiah,6103,6741,138,34738.0,12982,0.4701124634108766,-638
Mississippi,Covington,5435,3276,100,31684.0,8811,0.616842583134718,2159
Mississippi,DeSoto,43089,20591,2015,60111.0,65695,0.6558946647385646,22498
Mississippi,Forrest,15461,11716,887,37017.0,28064,0.5509193272519954,3745
Mississippi,Franklin,2721,1502,67,40081.0,4290,0.6342657342657343,1219
Mississippi,George,8696,1027,168,47313.0,9891,0.8791830957436053,7669
Mississippi,Greene,4335,974,60,40069.0,5369,0.8074129260569939,3361
Mississippi,Grenada,5970,4424,119,33026.0,10513,0.5678683534671359,1546
Mississippi,Hancock,13811,3344,482,46542.0,17637,0.7830696830526733,10467
Mississippi,Harrison,40354,21169,1790,43095.0,63313,0.6373730513480643,19185
Mississippi,Hinds,25275,67594,1812,38773.0,94681,0.26694901828244316,-42319
Mississippi,Holmes,1309,6689,78,20800.0,8076,0.16208519068845964,-5380
Mississippi,Humphreys,1151,3071,31,23442.0,4253,0.27063249470961676,-1920
Mississippi,Issaquena,298,395,6,24306.0,699,0.4263233190271817,-97
Mississippi,Itawamba,8470,1117,150,35380.0,9737,0.8698777857656362,7353
Mississippi,Jackson,33629,14657,1281,49158.0,49567,0.678455423971594,18972
Mississippi,Jasper,4038,4368,69,34993.0,8475,0.47646017699115045,-330
Mississippi,Jefferson,490,3337,33,23773.0,3860,0.12694300518134716,-2847
Mississippi,Jefferson Davis,2466,3720,51,26429.0,6237,0.3953823953823954,-1254
Mississippi,Jones,20133,7791,428,37846.0,28352,0.7101086343115124,12342
Mississippi,Kemper,1778,2827,34,29925.0,4639,0.3832722569519293,-1049
Mississippi,Lafayette,10872,7969,802,43162.0,19643,0.5534796110573741,2903
Mississippi,Lamar,18751,5190,651,53888.0,24592,0.7624837345478205,13561
Mississippi,Lauderdale,17741,11269,496,38399.0,29506,0.6012675388056666,6472
Mississippi,Lawrence,4091,2195,78,38155.0,6364,0.6428346951602766,1896
Mississippi,Leake,4782,3584,83,32657.0,8449,0.5659841401349273,1198
Mississippi,Lee,22220,10029,664,43224.0,32913,0.6751131771640385,12191
Mississippi,Leflore,3212,7787,141,25356.0,11140,0.2883303411131059,-4575
Mississippi,Lincoln,10550,4458,185,36250.0,15193,0.6943987362601198,6092
Mississippi,Lowndes,13271,11819,485,41219.0,25575,0.5189051808406647,1452
Mississippi,Madison,28265,20343,1194,65924.0,49802,0.5675474880526886,7922
Mississippi,Marion,7836,3677,180,30914.0,11693,0.6701445309159326,4159
Mississippi,Marshall,6587,8023,229,40598.0,14839,0.4438978367814543,-1436
Mississippi,Monroe,10167,5524,193,37345.0,15884,0.6400780659783429,4643
Mississippi,Montgomery,2818,2115,63,31207.0,4996,0.5640512409927942,703
Mississippi,Neshoba,7679,2715,159,35991.0,10553,0.7276603809343315,4964
Mississippi,Newton,6548,2756,134,35527.0,9438,0.6937910574274211,3792
Mississippi,Noxubee,1200,4347,27,31472.0,5574,0.21528525296017223,-3147
Mississippi,Oktibbeha,8576,8859,689,33431.0,18124,0.4731847274332377,-283
Mississippi,Panola,7449,7431,184,37556.0,15064,0.494490175252257,18
Mississippi,Pearl River,17782,3604,497,41598.0,21883,0.8125942512452589,14178
Mississippi,Perry,4135,1220,77,34774.0,5432,0.7612297496318114,2915
Mississippi,Pike,8009,8043,258,31511.0,16310,0.49104843654199876,-34
Mississippi,Pontotoc,10336,2386,262,39869.0,12984,0.7960566851509551,7950
Mississippi,Prentiss,7648,2067,157,33509.0,9872,0.7747163695299838,5581
Mississippi,Quitman,1001,2312,52,24835.0,3365,0.2974739970282318,-1311
Mississippi,Rankin,47178,14110,1480,59370.0,62768,0.7516250318633698,33068
Mississippi,Scott,6122,4268,132,32615.0,10522,0.5818285497053792,1854
Mississippi,Sharkey,692,1479,19,28878.0,2190,0.31598173515981737,-787
Mississippi,Simpson,7393,3874,152,37285.0,11419,0.6474297223925037,3519
Mississippi,Smith,5928,1617,82,33696.0,7627,0.7772387570473318,4311
Mississippi,Stone,5306,1573,166,44995.0,7045,0.7531582682753726,3733
Mississippi,Sunflower,2794,6725,79,27126.0,9598,0.2911023129818712,-3931
Mississippi,Tallahatchie,2462,3337,71,29837.0,5870,0.4194207836456559,-875
Mississippi,Tate,7495,3926,206,43883.0,11627,0.6446202803818698,3569
Mississippi,Tippah,7240,1842,153,37109.0,9235,0.7839740119112074,5398
Mississippi,Tishomingo,7166,999,206,35364.0,8371,0.8560506510572213,6167
Mississippi,Tunica,853,2667,47,31918.0,3567,0.23913652929632745,-1814
Mississippi,Union,9235,2012,249,37898.0,11496,0.8033228949199722,7223
Mississippi,Walthall,4056,2790,73,30571.0,6919,0.5862118803295274,1266
Mississippi,Warren,9767,9284,365,40475.0,19416,0.5030387309435517,483
Mississippi,Washington,5244,11380,201,28452.0,16825,0.3116790490341753,-6136
Mississippi,Wayne,5990,3524,85,34458.0,9599,0.6240233357641422,2466
Mississippi,Webster,3976,1019,74,37083.0,5069,0.7843756164924048,2957
Mississippi,Wilkinson,1318,2857,43,25846.0,4218,0.31247036510194404,-1539
Mississippi,Winston,4910,3850,121,32820.0,8881,0.552865668280599,1060
Mississippi,Yalobusha,3376,2582,119,34749.0,6077,0.5555372716801054,794
Mississippi,Yazoo,4598,5369,103,27560.0,10070,0.45660377358490567,-771
Missouri,Adair,6030,3500,696,37967.0,10226,0.589673381576374,2530
Missouri,Andrew,6665,2045,430,54804.0,9140,0.7292122538293216,4620
Missouri,Atchison,2060,541,123,43438.0,2724,0.7562408223201175,1519
Missouri,Audrain,6981,2570,510,41930.0,10061,0.6938674088062817,4411
Missouri,Barry,11428,2710,467,37869.0,14605,0.7824717562478604,8718
Missouri,Barton,4959,795,185,38877.0,5939,0.8349890553965315,4164
Missouri,Bates,6001,1618,404,41520.0,8023,0.7479745731023308,4383
Missouri,Benton,7213,2025,74,33428.0,9312,0.7745919243986255,5188
Missouri,Bollinger,4827,705,144,39493.0,5676,0.8504228329809725,4122
Missouri,Boone,36200,41125,6543,50813.0,83868,0.43163065770019554,-4925
Missouri,Buchanan,21320,12013,2326,46680.0,35659,0.5978855267954793,9307
Missouri,Butler,13650,3036,573,36302.0,17259,0.7908917086737355,10614
Missouri,Caldwell,3232,838,242,44722.0,4312,0.7495361781076066,2394
Missouri,Callaway,13057,4989,1147,50362.0,19193,0.6803001094148908,8068
Missouri,Camden,16944,4768,802,46747.0,22514,0.7525983832282136,12176
Missouri,Cape Girardeau,27017,8492,1529,48458.0,37038,0.7294400345591014,18525
Missouri,Carroll,3480,745,136,41537.0,4361,0.7979821141939922,2735
Missouri,Carter,2324,436,84,37162.0,2844,0.8171589310829818,1888
Missouri,Cass,33098,14846,3046,63613.0,50990,0.6491076681702295,18252
Missouri,Cedar,5021,1011,256,33720.0,6288,0.7985050890585241,4010
Missouri,Chariton,2950,888,131,41773.0,3969,0.7432602670697909,2062
Missouri,Christian,30946,8508,2077,54392.0,41531,0.7451301437480436,22438
Missouri,Clark,2458,724,33,45169.0,3215,0.7645412130637637,1734
Missouri,Clay,57476,45304,7396,63702.0,110176,0.5216744118501307,12172
Missouri,Clinton,7067,2572,569,57486.0,10208,0.6923001567398119,4495
Missouri,Cole,24616,10913,1845,54130.0,37374,0.6586396960453791,13703
Missouri,Cooper,5624,1932,430,44917.0,7986,0.7042324067117456,3692
Missouri,Crawford,7724,1824,148,36983.0,9696,0.7966171617161716,5900
Missouri,Dade,3184,637,130,37904.0,3951,0.8058719311566692,2547
Missouri,Dallas,5895,1272,286,37695.0,7453,0.7909566617469476,4623
Missouri,Daviess,2767,730,96,43669.0,3593,0.770108544391873,2037
Missouri,DeKalb,3540,824,230,43538.0,4594,0.7705703090988245,2716
Missouri,Dent,5600,978,213,38020.0,6791,0.8246208216757474,4622
Missouri,Douglas,5486,984,196,31333.0,6666,0.8229822982298229,4502
Missouri,Dunklin,8026,2360,192,31220.0,10578,0.7587445641898279,5666
Missouri,Franklin,35430,12341,2342,50895.0,50113,0.7070021750843095,23089
Missouri,Gasconade,5670,1520,255,45505.0,7445,0.7615849563465413,4150
Missouri,Gentry,2304,605,134,44024.0,3043,0.7571475517581334,1699
Missouri,Greene,78035,42728,8468,41908.0,129231,0.6038411836169341,35307
Missouri,Grundy,3462,780,68,40187.0,4310,0.8032482598607888,2682
Missouri,Harrison,2965,574,150,41173.0,3689,0.8037408511791814,2391
Missouri,Henry,7075,2357,434,42707.0,9866,0.7171092641394688,4718
Missouri,Hickory,3542,1016,166,33113.0,4724,0.7497883149872989,2526
Missouri,Holt,1926,347,82,41017.0,2355,0.8178343949044586,1579
Missouri,Howard,3277,1283,308,45762.0,4868,0.6731717337715695,1994
Missouri,Howell,13893,2881,681,33964.0,17455,0.7959323975938126,11012
Missouri,Iron,3173,933,163,36354.0,4269,0.743265401733427,2240
Missouri,Jackson,91557,71237,10481,48104.0,173275,0.5283912855287837,20320
Missouri,Jasper,35070,10572,2684,42648.0,48326,0.7256963125439722,24498
Missouri,Jefferson,69036,31568,5634,58232.0,106238,0.6498239801201077,37468
Missouri,Johnson,13719,5930,1483,48977.0,21132,0.6492049971607041,7789
Missouri,Knox,1416,379,75,38816.0,1870,0.7572192513368984,1037
Missouri,Laclede,12881,2553,617,40436.0,16051,0.8025045168525325,10328
Missouri,Lafayette,10988,4053,835,50830.0,15876,0.6921138825900731,6935
Missouri,Lawrence,13089,2901,725,40505.0,16715,0.7830690996111277,10188
Missouri,Lewis,3344,934,178,45708.0,4456,0.7504488330341114,2410
Missouri,Lincoln,18159,5575,1228,55249.0,24962,0.727465747936864,12584
Missouri,Linn,4088,1240,259,39286.0,5587,0.7316985860032218,2848
Missouri,Livingston,4879,1265,277,44266.0,6421,0.7598504905777916,3614
Missouri,McDonald,6599,1329,314,38846.0,8242,0.8006551807813638,5270
Missouri,Macon,5798,1548,275,37099.0,7621,0.7607925469098543,4250
Missouri,Madison,4102,1005,214,36359.0,5321,0.770907724112009,3097
Missouri,Maries,3561,794,145,40542.0,4500,0.7913333333333333,2767
Missouri,Marion,9419,2994,525,43828.0,12938,0.7280105116710466,6425
Missouri,Mercer,1486,216,43,41817.0,1745,0.8515759312320917,1270
Missouri,Miller,9285,1750,381,40057.0,11416,0.8133321653819201,7535
Missouri,Mississippi,3600,1458,111,29214.0,5169,0.6964596633778294,2142
Missouri,Moniteau,5347,1237,246,48974.0,6830,0.7828696925329429,4110
Missouri,Monroe,3159,853,144,41201.0,4156,0.7601058710298364,2306
Missouri,Montgomery,4127,1119,183,41096.0,5429,0.7601768281451464,3008
Missouri,Morgan,6760,1768,293,32807.0,8821,0.7663530211994105,4992
Missouri,New Madrid,5270,1933,154,31615.0,7357,0.7163245888269675,3337
Missouri,Newton,20553,4990,1063,44474.0,26606,0.7724949259565511,15563
Missouri,Nodaway,6380,2529,549,39908.0,9458,0.6745612180164939,3851
Missouri,Oregon,3671,865,132,30442.0,4668,0.7864181662382177,2806
Missouri,Osage,5856,998,236,54119.0,7090,0.8259520451339916,4858
Missouri,Ozark,3639,724,142,31087.0,4505,0.8077691453940067,2915
Missouri,Pemiscot,3964,1947,116,31671.0,6027,0.6577069852331177,2017
Missouri,Perry,6908,1520,312,53014.0,8740,0.7903890160183067,5388
Missouri,Pettis,12810,4324,977,40467.0,18111,0.7073049527911214,8486
Missouri,Phelps,12709,4766,1078,41603.0,18553,0.6850105104295802,7943
Missouri,Pike,5274,1806,302,42779.0,7382,0.7144405310214034,3468
Missouri,Platte,25933,20057,2895,70879.0,48885,0.5304899253349699,5876
Missouri,Polk,10438,2631,694,42483.0,13763,0.7584102303276902,7807
Missouri,Pulaski,9876,2922,690,49216.0,13488,0.7322064056939501,6954
Missouri,Putnam,1936,353,57,38125.0,2346,0.8252344416027281,1583
Missouri,Ralls,3969,1138,159,48919.0,5266,0.7537030003797949,2831
Missouri,Randolph,7529,2283,497,40638.0,10309,0.7303327189834126,5246
Missouri,Ray,7104,3090,675,53459.0,10869,0.6536019873033397,4014
Missouri,Reynolds,2406,540,92,36736.0,3038,0.7919684002633312,1866
Missouri,Ripley,4522,830,172,34145.0,5524,0.8186097031136857,3692
Missouri,St. Charles,121650,68626,10729,75603.0,201005,0.6052088256511032,53024
Missouri,St. Clair,3501,936,193,33750.0,4630,0.7561555075593952,2565
Missouri,Ste. Genevieve,5496,2542,431,49356.0,8469,0.648955012398158,2954
Missouri,St. Francois,17468,6250,1010,41461.0,24728,0.7064056939501779,11218
Missouri,St. Louis County,202434,286704,25720,61103.0,514858,0.3931841400929965,-84270
Missouri,Saline,5977,2789,508,40645.0,9274,0.6444899719646323,3188
Missouri,Schuyler,1505,354,77,37583.0,1936,0.7773760330578512,1151
Missouri,Scotland,1525,365,78,41336.0,1968,0.7748983739837398,1160
Missouri,Scott,13168,3575,513,40276.0,17256,0.7630968938340288,9593
Missouri,Shannon,2966,776,162,32284.0,3904,0.7597336065573771,2190
Missouri,Shelby,2524,606,125,41351.0,3255,0.7754224270353303,1918
Missouri,Stoddard,11079,1876,336,38096.0,13291,0.8335715897976074,9203
Missouri,Stone,13158,2887,522,41944.0,16567,0.7942294923643387,10271
Missouri,Sullivan,1884,526,76,42639.0,2486,0.7578439259855189,1358
Missouri,Taney,18276,4373,866,38040.0,23515,0.777206038698703,13903
Missouri,Texas,8875,1728,353,35730.0,10956,0.8100584154801023,7147
Missouri,Vernon,6533,1707,359,40655.0,8599,0.7597395045935574,4826
Missouri,Warren,11111,3915,758,51509.0,15784,0.7039406994424734,7196
Missouri,Washington,7048,1926,308,36701.0,9282,0.7593191122602887,5122
Missouri,Wayne,4658,948,49,33954.0,5655,0.8236958443854996,3710
Missouri,Webster,12840,3177,726,44814.0,16743,0.7668876545421968,9663
Missouri,Worth,808,195,43,44974.0,1046,0.7724665391969407,613
Missouri,Wright,6707,1170,242,30581.0,8119,0.8260869565217391,5537
Missouri,St. Louis City,20832,104235,6124,36809.0,131191,0.15879138050628472,-83403
Montana,Beaverhead,3353,1143,353,38194.0,4849,0.6914827799546298,2210
Montana,Big Horn,1853,2094,290,44136.0,4237,0.4373377389662497,-241
Montana,Blaine,1268,1202,214,36875.0,2684,0.47242921013412814,66
Montana,Broadwater,2348,573,212,50946.0,3133,0.7494414299393553,1775
Montana,Carbon,3748,1828,415,52869.0,5991,0.6256050742780838,1920
Montana,Carter,678,70,38,46985.0,786,0.8625954198473282,608
Montana,Cascade,19632,12175,2764,45469.0,34571,0.567874808365393,7457
Montana,Chouteau,1679,732,192,38735.0,2603,0.6450249711870918,947
Montana,Custer,3657,1176,352,50146.0,5185,0.7053037608486017,2481
Montana,Daniels,730,168,64,51108.0,962,0.7588357588357588,562
Montana,Dawson,3320,787,267,57591.0,4374,0.7590306355738454,2533
Montana,Deer Lodge,1763,2058,385,39212.0,4206,0.4191631003328578,-295
Montana,Fallon,1279,154,51,50114.0,1484,0.8618598382749326,1125
Montana,Fergus,4269,1202,369,42357.0,5840,0.7309931506849315,3067
Montana,Flathead,30240,13293,3038,48407.0,46571,0.6493311288140688,16947
Montana,Gallatin,23802,24246,5771,57021.0,53819,0.44226016834203535,-444
Montana,Garfield,653,34,31,42614.0,718,0.9094707520891365,619
Montana,Glacier,1620,3121,334,29181.0,5075,0.3192118226600985,-1501
Montana,Golden Valley,365,71,38,44000.0,474,0.770042194092827,294
Montana,Granite,1192,472,113,48688.0,1777,0.670793472144063,720
Montana,Hill,3478,2371,596,42979.0,6445,0.5396431342125679,1107
Montana,Jefferson,4177,1998,539,62939.0,6714,0.6221328567173071,2179
Montana,Judith Basin,872,235,101,45347.0,1208,0.7218543046357616,637
Montana,Lake,7530,4776,875,39898.0,13181,0.5712768378726956,2754
Montana,Lewis and Clark,16895,14478,3105,59170.0,34478,0.49002262312199085,2417
Montana,Liberty,698,206,57,46597.0,961,0.7263267429760666,492
Montana,Lincoln,6729,2041,560,35461.0,9330,0.7212218649517685,4688
Montana,McCone,862,154,44,42330.0,1060,0.8132075471698114,708
Montana,Madison,3297,1180,301,47617.0,4778,0.6900376726663876,2117
Montana,Meagher,729,193,55,39032.0,977,0.7461617195496417,536
Montana,Mineral,1330,519,163,37143.0,2012,0.6610337972166997,811
Montana,Missoula,22250,31543,5410,46371.0,59203,0.37582554938094354,-9293
Montana,Musselshell,1967,332,142,41557.0,2441,0.8058172879967227,1635
Montana,Park,4980,3595,784,43385.0,9359,0.5321081312105994,1385
Montana,Petroleum,278,30,14,38250.0,322,0.8633540372670807,248
Montana,Phillips,1723,318,130,38692.0,2171,0.7936434822662367,1405
Montana,Pondera,1799,738,186,42193.0,2723,0.6606683804627249,1061
Montana,Powder River,884,127,42,47955.0,1053,0.8395061728395061,757
Montana,Powell,2029,551,214,43064.0,2794,0.7261989978525412,1478
Montana,Prairie,556,100,33,44643.0,689,0.806966618287373,456
Montana,Ravalli,14810,6223,1523,40546.0,22556,0.6565880475261571,8587
Montana,Richland,3908,671,292,65638.0,4871,0.8022993225210429,3237
Montana,Roosevelt,1797,1560,295,34481.0,3652,0.4920591456736035,237
Montana,Rosebud,2253,987,213,55609.0,3453,0.6524761077324066,1266
Montana,Sanders,4286,1218,449,34336.0,5953,0.7199731227952293,3068
Montana,Sheridan,1241,477,117,52308.0,1835,0.6762942779291553,764
Montana,Silver Bow,6376,8619,1457,39580.0,16452,0.387551665451009,-2243
Montana,Stillwater,3661,908,304,59603.0,4873,0.751282577467679,2753
Montana,Sweet Grass,1595,402,110,50813.0,2107,0.757000474608448,1193
Montana,Teton,2170,808,210,49047.0,3188,0.6806775407779172,1362
Montana,Toole,1497,402,138,46588.0,2037,0.7349042709867453,1095
Montana,Treasure,351,59,33,42500.0,443,0.7923250564334086,292
Montana,Valley,2698,886,310,49977.0,3894,0.6928608115048793,1812
Montana,Wheatland,702,179,65,36076.0,946,0.7420718816067653,523
Montana,Wibaux,463,55,23,40833.0,541,0.8558225508317929,408
Montana,Yellowstone,40920,22171,6017,55032.0,69108,0.5921166869248133,18749
Nebraska,Adams,9287,3302,924,51201.0,13513,0.6872641160364094,5985
Nebraska,Antelope,2732,383,166,46381.0,3281,0.8326729655592807,2349
Nebraska,Arthur,244,17,12,40375.0,273,0.8937728937728938,227
Nebraska,Banner,357,19,26,50833.0,402,0.8880597014925373,338
Nebraska,Blaine,276,30,11,50350.0,317,0.8706624605678234,246
Nebraska,Boone,2299,414,192,51890.0,2905,0.791394148020654,1885
Nebraska,Box Butte,3617,965,342,54444.0,4924,0.7345653939886271,2652
Nebraska,Boyd,983,128,45,42463.0,1156,0.8503460207612457,855
Nebraska,Brown,1385,153,59,37328.0,1597,0.8672510958046337,1232
Nebraska,Buffalo,14569,4763,1797,54098.0,21129,0.6895262435515169,9806
Nebraska,Burt,2367,930,261,47137.0,3558,0.6652613827993255,1437
Nebraska,Butler,3079,691,211,51166.0,3981,0.7734237628736499,2388
Nebraska,Cass,8452,3484,997,65385.0,12933,0.653521997989639,4968
Nebraska,Cedar,3532,571,317,54391.0,4420,0.7990950226244344,2961
Nebraska,Chase,1648,171,79,53496.0,1898,0.8682824025289779,1477
Nebraska,Cherry,2623,317,178,53059.0,3118,0.8412443874278384,2306
Nebraska,Cheyenne,3665,711,335,54215.0,4711,0.777966461473148,2954
Nebraska,Clay,2422,477,166,51613.0,3065,0.7902120717781403,1945
Nebraska,Colfax,2171,859,184,52712.0,3214,0.6754822650902302,1312
Nebraska,Cuming,3122,719,233,49181.0,4074,0.7663230240549829,2403
Nebraska,Custer,4695,641,316,47083.0,5652,0.8306794055201698,4054
Nebraska,Dakota,3616,2314,349,52336.0,6279,0.5758878802357064,1302
Nebraska,Dawes,2632,801,243,42685.0,3676,0.7159956474428727,1831
Nebraska,Dawson,5984,2136,515,49943.0,8635,0.6929936305732484,3848
Nebraska,Deuel,809,120,55,51786.0,984,0.8221544715447154,689
Nebraska,Dixon,2041,556,185,52813.0,2782,0.7336448598130841,1485
Nebraska,Dodge,9933,4544,1052,49830.0,15529,0.6396419602034903,5389
Nebraska,Douglas,108077,113798,18558,56003.0,240433,0.4495098426588696,-5721
Nebraska,Dundy,823,89,41,44583.0,953,0.863588667366212,734
Nebraska,Fillmore,2130,613,198,52070.0,2941,0.7242434546072765,1517
Nebraska,Franklin,1347,250,76,46531.0,1673,0.8051404662283324,1097
Nebraska,Frontier,1110,161,57,51192.0,1328,0.8358433734939759,949
Nebraska,Furnas,1921,304,115,40445.0,2340,0.8209401709401709,1617
Nebraska,Gage,6380,2935,733,48731.0,10048,0.634952229299363,3445
Nebraska,Garden,869,153,53,49805.0,1075,0.8083720930232559,716
Nebraska,Garfield,821,121,38,45227.0,980,0.8377551020408164,700
Nebraska,Gosper,794,166,50,60711.0,1010,0.7861386138613862,628
Nebraska,Grant,367,20,18,45625.0,405,0.9061728395061729,347
Nebraska,Greeley,912,210,53,48220.0,1175,0.7761702127659574,702
Nebraska,Hall,14408,6282,1370,51355.0,22060,0.6531278331822303,8126
Nebraska,Hamilton,3783,878,343,59760.0,5004,0.7559952038369304,2905
Nebraska,Harlan,1496,254,82,44630.0,1832,0.8165938864628821,1242
Nebraska,Hayes,472,30,12,44602.0,514,0.9182879377431906,442
Nebraska,Hitchcock,1232,161,75,41131.0,1468,0.8392370572207084,1071
Nebraska,Holt,4354,531,233,49607.0,5118,0.8507229386479094,3823
Nebraska,Hooker,355,40,22,38616.0,417,0.8513189448441247,315
Nebraska,Howard,2284,544,166,52247.0,2994,0.7628590514362057,1740
Nebraska,Jefferson,2399,837,258,44616.0,3494,0.6866056096164854,1562
Nebraska,Johnson,1355,563,171,47938.0,2089,0.6486357108664432,792
Nebraska,Kearney,2531,550,215,55068.0,3296,0.7679004854368932,1981
Nebraska,Keith,3235,571,228,43100.0,4034,0.8019335647000496,2664
Nebraska,Keya Paha,460,0,19,43333.0,479,0.9603340292275574,460
Nebraska,Kimball,1330,230,117,40344.0,1677,0.793082886106142,1100
Nebraska,Knox,3188,720,207,47692.0,4115,0.774726609963548,2468
Nebraska,Lancaster,61588,61898,12737,53730.0,136223,0.4521116111082563,-310
Nebraska,Lincoln,12164,2913,1054,52179.0,16131,0.7540760027276672,9251
Nebraska,Logan,400,32,21,51346.0,453,0.8830022075055187,368
Nebraska,Loup,323,48,14,56750.0,385,0.8389610389610389,275
Nebraska,McPherson,257,14,16,53750.0,287,0.8954703832752613,243
Nebraska,Madison,10628,2711,1004,48673.0,14343,0.7409886355713589,7917
Nebraska,Merrick,2926,602,260,50464.0,3788,0.7724392819429778,2324
Nebraska,Morrill,1802,284,123,43942.0,2209,0.8157537347215935,1518
Nebraska,Nance,1261,281,79,42429.0,1621,0.7779148673658236,980
Nebraska,Nemaha,2116,785,260,52736.0,3161,0.6694084150585258,1331
Nebraska,Nuckolls,1726,353,126,41576.0,2205,0.7827664399092971,1373
Nebraska,Otoe,4860,2025,572,52108.0,7457,0.6517366233069599,2835
Nebraska,Pawnee,974,279,74,40139.0,1327,0.7339864355689525,695
Nebraska,Perkins,1217,161,77,56797.0,1455,0.836426116838488,1056
Nebraska,Phelps,3849,572,274,51264.0,4695,0.8198083067092652,3277
Nebraska,Pierce,3052,382,196,53125.0,3630,0.840771349862259,2670
Nebraska,Platte,10965,2646,822,58473.0,14433,0.7597173144876325,8319
Nebraska,Polk,2028,413,141,57991.0,2582,0.7854376452362509,1615
Nebraska,Red Willow,4258,645,267,42457.0,5170,0.8235976789168279,3613
Nebraska,Richardson,2769,818,218,45929.0,3805,0.7277266754270696,1951
Nebraska,Rock,687,70,41,48750.0,798,0.8609022556390977,617
Nebraska,Saline,3004,1733,399,49332.0,5136,0.5848909657320872,1271
Nebraska,Sarpy,45143,28033,7404,72269.0,80580,0.5602258624968975,17110
Nebraska,Saunders,7555,2523,782,64475.0,10860,0.6956721915285451,5032
Nebraska,Scotts Bluff,10076,3207,1034,46632.0,14317,0.7037787245931411,6869
Nebraska,Seward,5454,1875,593,61563.0,7922,0.6884625094673062,3579
Nebraska,Sheridan,2211,287,110,42802.0,2608,0.8477760736196319,1924
Nebraska,Sherman,1150,340,83,46299.0,1573,0.7310870947234583,810
Nebraska,Sioux,616,81,39,46667.0,736,0.8369565217391305,535
Nebraska,Stanton,2187,417,197,58553.0,2801,0.7807925740806855,1770
Nebraska,Thayer,2051,499,140,45590.0,2690,0.762453531598513,1552
Nebraska,Thomas,344,30,19,54286.0,393,0.8753180661577609,314
Nebraska,Thurston,1043,919,126,42979.0,2088,0.49952107279693486,124
Nebraska,Valley,1780,339,86,44657.0,2205,0.8072562358276644,1441
Nebraska,Washington,7424,2623,785,65565.0,10832,0.6853766617429837,4801
Nebraska,Wayne,2693,835,248,55141.0,3776,0.7131885593220338,1858
Nebraska,Webster,1330,306,72,40313.0,1708,0.7786885245901639,1024
Nebraska,Wheeler,377,62,26,47452.0,465,0.810752688172043,315
Nebraska,York,4700,1186,495,55156.0,6381,0.7365616674502429,3514
Nevada,Churchill,7830,2210,898,45368.0,10938,0.7158529895776193,5620
Nevada,Clark,320057,402227,44872,52629.0,767156,0.4171993701411447,-82170
Nevada,Douglas,17415,8454,2016,59769.0,27885,0.6245293168370092,8961
Nevada,Elko,13551,3401,1607,74672.0,18559,0.7301578748855003,10150
Nevada,Esmeralda,329,65,29,43125.0,423,0.7777777777777778,264
Nevada,Eureka,723,74,57,70000.0,854,0.8466042154566745,649
Nevada,Humboldt,4521,1386,526,67295.0,6433,0.7027825275921032,3135
Nevada,Lander,1828,403,182,78077.0,2413,0.757563199336925,1425
Nevada,Lincoln,1671,285,176,49406.0,2132,0.7837711069418386,1386
Nevada,Lyon,16005,6146,1611,49007.0,23762,0.6735544146115647,9859
Nevada,Mineral,1179,637,181,37750.0,1997,0.5903855783675513,542
Nevada,Nye,13324,5094,1177,42266.0,19595,0.6799693799438632,8230
Nevada,Pershing,1403,430,149,45192.0,1982,0.7078708375378405,973
Nevada,Storey,1616,752,190,65508.0,2558,0.6317435496481626,864
Nevada,Washoe,94758,97379,17772,54955.0,209909,0.45142418857695477,-2621
Nevada,White Pine,2723,707,343,58156.0,3773,0.7217068645640075,2016
Nevada,Carson City,13125,9610,2281,47948.0,25016,0.5246642149024624,3515
New Hampshire,Belknap,19315,13517,2213,61245.0,35045,0.5511485233271508,5798
New Hampshire,Carroll,14635,12987,1994,56289.0,29616,0.49415856293895194,1648
New Hampshire,Cheshire,16876,22064,2955,58359.0,41895,0.40281656522258025,-5188
New Hampshire,Coos,7952,6563,1112,45154.0,15627,0.5088628655532091,1389
New Hampshire,Grafton,19010,28510,3671,58107.0,51191,0.3713543396300131,-9500
New Hampshire,Hillsborough,100013,99589,14555,73189.0,214157,0.4670078493815285,424
New Hampshire,Merrimack,37674,40198,5776,67181.0,83648,0.450387337413925,-2524
New Hampshire,Rockingham,90447,79994,10993,82398.0,181434,0.4985118555507788,10453
New Hampshire,Strafford,29072,34894,5034,63533.0,69000,0.42133333333333334,-5822
New Hampshire,Sullivan,10796,10210,1677,58454.0,22683,0.4759511528457435,586
New Jersey,Atlantic,52690,60924,3677,55456.0,117291,0.4492245781858796,-8234
New Jersey,Bergen,175529,231211,12556,88487.0,419296,0.41862789055941385,-55682
New Jersey,Burlington,89272,121725,7946,80034.0,218943,0.40774082752131835,-32453
New Jersey,Camden,72631,146717,7244,63028.0,226592,0.32053647083745235,-74086
New Jersey,Cape May,28446,18750,1526,59338.0,48722,0.5838430277903206,9696
New Jersey,Cumberland,24453,27771,1780,49537.0,54004,0.45279979260795494,-3318
New Jersey,Essex,63176,240837,6921,54860.0,310934,0.20318138254420554,-177661
New Jersey,Gloucester,67544,66870,5128,78592.0,139542,0.48404064726032303,674
New Jersey,Hudson,49043,163917,6415,60894.0,219375,0.22355783475783475,-114874
New Jersey,Hunterdon,38712,28898,3226,108177.0,70836,0.5465017787565645,9814
New Jersey,Mercer,46193,104775,5561,73966.0,156529,0.29510825470040697,-58582
New Jersey,Middlesex,122953,193044,10105,80716.0,326102,0.3770384726251296,-70091
New Jersey,Monmouth,166723,137181,10473,87297.0,314377,0.5303282364804041,29542
New Jersey,Morris,126071,115249,9096,102798.0,250416,0.5034462654143506,10822
New Jersey,Ocean,179079,87150,8133,63108.0,274362,0.6527106523498152,91929
New Jersey,Passaic,72902,116759,5141,61664.0,194802,0.37423640414369463,-43857
New Jersey,Salem,16381,11904,1209,61341.0,29494,0.5554010985285143,4477
New Jersey,Somerset,65505,85689,5898,102405.0,157092,0.41698495149339243,-20184
New Jersey,Sussex,46658,24212,3256,87388.0,74126,0.6294417613253109,22446
New Jersey,Union,68114,147414,6447,70476.0,221975,0.30685437549273564,-79300
New Jersey,Warren,29858,17281,2097,72999.0,49236,0.6064261922170769,12577
New Mexico,Bernalillo,94698,143417,36547,48994.0,274662,0.3447801297594862,-48719
New Mexico,Catron,1464,427,158,38142.0,2049,0.7144948755490483,1037
New Mexico,Chaves,12872,5534,1865,41356.0,20271,0.6349958068176212,7338
New Mexico,Cibola,3195,3741,1127,36160.0,8063,0.3962544958452189,-546
New Mexico,Colfax,2585,2129,618,32693.0,5332,0.4848087021755439,456
New Mexico,Curry,9035,3121,1214,42170.0,13370,0.6757666417352282,5914
New Mexico,De Baca,620,193,97,31197.0,910,0.6813186813186813,427
New Mexico,Dona Ana,25374,37947,7327,38636.0,70648,0.35916091042917,-12573
New Mexico,Eddy,13147,5033,1487,59625.0,19667,0.6684801952509279,8114
New Mexico,Grant,5288,6276,1247,38890.0,12811,0.412770275544454,-988
New Mexico,Guadalupe,595,970,262,26692.0,1827,0.32567049808429116,-375
New Mexico,Harding,311,156,60,32404.0,527,0.5901328273244781,155
New Mexico,Hidalgo,910,784,178,34528.0,1872,0.4861111111111111,126
New Mexico,Lea,12495,3930,1287,58152.0,17712,0.7054539295392954,8565
New Mexico,Lincoln,5896,2331,675,40065.0,8902,0.6623230734666367,3565
New Mexico,Los Alamos,3359,5562,1964,105902.0,10885,0.30858980248047774,-2203
New Mexico,Luna,3478,3195,622,27326.0,7295,0.47676490747087047,283
New Mexico,McKinley,5104,13576,3023,29272.0,21703,0.2351748606183477,-8472
New Mexico,Mora,665,1536,240,21190.0,2441,0.2724293322408849,-871
New Mexico,Otero,11887,6124,2049,41502.0,20060,0.5925722831505483,5763
New Mexico,Quay,2212,1017,343,28159.0,3572,0.6192609182530795,1195
New Mexico,Rio Arriba,3599,9592,1687,33972.0,14878,0.2419007931173545,-5993
New Mexico,Roosevelt,3884,1454,612,34933.0,5950,0.6527731092436975,2430
New Mexico,Sandoval,25905,27707,8078,60158.0,61690,0.4199221916031772,-1802
New Mexico,San Juan,27946,12865,5299,48624.0,46110,0.606072435480373,15081
New Mexico,San Miguel,2313,7285,1153,27000.0,10751,0.2151427774160543,-4972
New Mexico,Santa Fe,14332,50793,6309,55370.0,71434,0.20063275191085478,-36461
New Mexico,Sierra,3010,1612,559,29679.0,5181,0.5809689249179695,1398
New Mexico,Socorro,2616,3313,939,34542.0,6868,0.3808969132207338,-697
New Mexico,Taos,2727,10668,1865,35323.0,15260,0.1787024901703801,-7941
New Mexico,Torrance,3714,1785,825,32067.0,6324,0.5872865275142315,1929
New Mexico,Union,1216,320,166,36420.0,1702,0.7144535840188014,896
New Mexico,Valencia,13215,10841,3536,41788.0,27592,0.4789431719338939,2374
Missouri,Kansas City,24654,97735,6212,51235.0,128601,0.19170924020808547,-73081
New York,Albany,47810,83077,8943,60904.0,139830,0.34191518272187654,-35267
New York,Allegany,12525,4882,1285,44085.0,18692,0.6700727583993152,7643
New York,Bronx,37797,353646,8079,35302.0,399522,0.09460555363659573,-315849
New York,Broome,40943,39212,5917,47744.0,86072,0.47568314899154196,1731
New York,Cattaraugus,19692,9497,1972,43884.0,31161,0.6319437758736882,10195
New York,Cayuga,17384,13522,2266,53114.0,33172,0.5240564331363801,3862
New York,Chautauqua,31594,19091,3549,43211.0,54234,0.582549692075082,12503
New York,Chemung,20097,13757,2265,49578.0,36119,0.5564107533431158,6340
New York,Chenango,11921,6775,1464,46979.0,20160,0.5913194444444444,5146
New York,Clinton,14449,15059,2597,50502.0,32105,0.4500545086435135,-610
New York,Columbia,13756,15284,1862,59916.0,30902,0.44514918128276487,-1528
New York,Cortland,9900,8771,1573,50910.0,20244,0.4890337877889745,1129
New York,Delaware,11942,6627,1223,46055.0,19792,0.6033751010509296,5315
New York,Dutchess,61797,62261,6876,72706.0,130934,0.4719706111476011,-464
New York,Erie,188303,215456,19866,52744.0,423625,0.4445039834759516,-27153
New York,Essex,7958,7762,1498,53244.0,17218,0.4621907306307353,196
New York,Franklin,8221,7297,1434,49782.0,16952,0.48495752713544127,924
New York,Fulton,13462,6496,1256,46090.0,21214,0.6345809371169983,6966
New York,Genesee,16915,7650,1867,52641.0,26432,0.6399440072639225,9265
New York,Greene,13073,7405,1572,51013.0,22050,0.5928798185941043,5668
New York,Hamilton,2064,949,212,52708.0,3225,0.64,1115
New York,Herkimer,16699,8083,1473,48893.0,26255,0.6360312321462579,8616
New York,Jefferson,21763,13809,2664,49911.0,38236,0.569175645988074,7954
New York,Kings,141044,640553,24008,50640.0,805605,0.17507835725945098,-499509
New York,Lewis,7400,3146,779,49976.0,11325,0.6534216335540839,4254
New York,Livingston,17290,10697,2044,52724.0,30031,0.5757384036495621,6593
New York,Madison,15936,11667,2461,55858.0,30064,0.5300691857370942,4269
New York,Monroe,136582,188592,22616,53568.0,347790,0.39271399407688545,-52010
New York,Montgomery,11301,6595,1158,44455.0,19054,0.5931038102235751,4706
New York,Nassau,288313,326088,22566,102044.0,636967,0.45263412390280816,-37775
New York,New York,64929,579013,24997,75513.0,668939,0.09706266191685639,-514084
New York,Niagara,51961,35559,4882,50094.0,92402,0.5623363130668168,16402
New York,Oneida,51437,33743,5829,49838.0,91009,0.5651858607390478,17694
New York,Onondaga,83649,112337,12454,55717.0,208440,0.4013097294185377,-28688
New York,Ontario,26029,22233,3996,58070.0,52258,0.49808641739063875,3796
New York,Orange,76645,68278,7098,71910.0,152021,0.5041737654666132,8367
New York,Orleans,10936,4470,974,48731.0,16380,0.6676434676434676,6466
New York,Oswego,27688,17095,3397,49571.0,48180,0.5746782897467829,10593
New York,Otsego,13308,10451,1909,49689.0,25668,0.5184665731650304,2857
New York,Putnam,27024,19366,2173,97606.0,48563,0.5564730350266663,7658
New York,Queens,149341,517220,19832,59758.0,686393,0.21757360579143437,-367879
New York,Rensselaer,33726,32717,5119,61754.0,71562,0.47128364215645174,1009
New York,Richmond,101437,74143,5380,74021.0,180960,0.5605492926613617,27294
New York,Rockland,60911,69342,4834,86134.0,135087,0.45090201129642377,-8431
New York,St. Lawrence,19942,16488,2728,46313.0,39158,0.5092701363706011,3454
New York,Saratoga,54575,50913,8606,74080.0,114094,0.47833365470576894,3662
New York,Schenectady,28953,33747,4580,59959.0,67280,0.4303359096313912,-4794
New York,Schoharie,8831,4240,979,50607.0,14050,0.6285409252669039,4591
New York,Schuyler,5050,3091,631,47229.0,8772,0.5756953944368445,1959
New York,Seneca,7236,5697,1047,50073.0,13980,0.5175965665236052,1539
New York,Steuben,26831,12526,2645,48823.0,42002,0.6388029141469453,14305
New York,Suffolk,350570,303951,26733,90128.0,681254,0.5145951436615418,46619
New York,Sullivan,15931,12568,1456,52027.0,29955,0.5318310799532632,3363
New York,Tioga,13260,7526,1513,58115.0,22299,0.5946454997981973,5734
New York,Tompkins,10371,28890,3417,54133.0,42678,0.24300576409391256,-18519
New York,Ulster,34006,42101,5248,60393.0,81355,0.41799520619507097,-8095
New York,Warren,15751,13091,2566,57174.0,31408,0.5014964340295466,2660
New York,Washington,13610,9098,1820,51449.0,24528,0.5548760600130463,4512
New York,Wayne,23380,13473,2834,51627.0,39687,0.5891097840602716,9907
New York,Westchester,131238,272926,16491,86226.0,420655,0.3119848807217316,-141688
New York,Wyoming,12442,3904,952,53612.0,17298,0.7192739044976297,8538
New York,Yates,5660,3659,747,50105.0,10066,0.5622888933041923,2001
North Carolina,Alamance,38815,29833,2509,43209.0,71157,0.5454839299014854,8982
North Carolina,Alexander,13893,3767,611,40404.0,18271,0.7603853100541842,10126
North Carolina,Alleghany,3814,1306,195,38352.0,5315,0.7175917215428034,2508
North Carolina,Anson,4506,5859,180,34656.0,10545,0.42731152204836415,-1353
North Carolina,Ashe,9412,3500,512,37360.0,13424,0.7011323003575686,5912
North Carolina,Avery,6298,1689,262,35891.0,8249,0.763486483210086,4609
North Carolina,Beaufort,14543,8764,631,40906.0,23938,0.607527780098588,5779
North Carolina,Bertie,3456,5778,113,31129.0,9347,0.36974430298491495,-2322
North Carolina,Bladen,8550,7058,289,30408.0,15897,0.5378373277976977,1492
North Carolina,Brunswick,42720,23282,2349,49356.0,68351,0.6250091439774107,19438
North Carolina,Buncombe,55716,75452,7779,46902.0,138947,0.4009874268606015,-19736
North Carolina,Burke,26238,11251,1431,39759.0,38920,0.6741521068859199,14987
North Carolina,Cabarrus,53819,35521,3949,58970.0,93289,0.5769061732894554,18298
North Carolina,Caldwell,26621,8425,1274,37118.0,36320,0.7329570484581498,18196
North Carolina,Camden,3546,1274,186,60714.0,5006,0.7083499800239712,2272
North Carolina,Carteret,26569,9939,1273,50599.0,37781,0.7032370768375639,16630
North Carolina,Caswell,6026,4792,252,38310.0,11070,0.5443541102077687,1234
North Carolina,Catawba,48324,21216,2811,45450.0,72351,0.6679106024795787,27108
North Carolina,Chatham,17105,21065,1679,58555.0,39849,0.4292454013902482,-3960
North Carolina,Cherokee,10844,2860,477,35284.0,14181,0.7646851420915309,7984
North Carolina,Chowan,4014,2992,222,41156.0,7228,0.5553403431101273,1022
North Carolina,Clay,4437,1367,206,36296.0,6010,0.7382695507487521,3070
North Carolina,Cleveland,28479,14964,1230,39134.0,44673,0.6374991605667854,13515
North Carolina,Columbus,14272,9063,397,35847.0,23732,0.6013821001179842,5209
North Carolina,Craven,27731,17630,1640,47957.0,47001,0.5900087232186549,10101
North Carolina,Cumberland,51265,71605,4636,44810.0,127506,0.4020595109249761,-20340
North Carolina,Currituck,9163,2913,593,61086.0,12669,0.7232615044597048,6250
North Carolina,Dare,11460,7222,927,54787.0,19609,0.5844255188943852,4238
North Carolina,Davidson,54317,18109,2430,44469.0,74856,0.7256198567917067,36208
North Carolina,Davie,15602,5270,884,51662.0,21756,0.7171355028497886,10332
North Carolina,Duplin,12217,8283,356,35364.0,20856,0.5857786728039892,3934
North Carolina,Durham,28350,121250,6534,54093.0,156134,0.18157480113236066,-92900
North Carolina,Edgecombe,8261,16224,401,32298.0,24886,0.33195370891264164,-7963
North Carolina,Forsyth,75975,94464,7873,46283.0,178312,0.42607900758221545,-18489
North Carolina,Franklin,16368,12874,1126,44272.0,30368,0.5389884088514225,3494
North Carolina,Gaston,61798,31177,3456,44288.0,96431,0.640852008171646,30621
North Carolina,Gates,2874,2385,133,51582.0,5392,0.5330118694362018,489
North Carolina,Graham,3283,768,117,34778.0,4168,0.7876679462571977,2515
North Carolina,Granville,13591,12909,853,50317.0,27353,0.496874200270537,682
North Carolina,Greene,4374,3605,116,37190.0,8095,0.5403335392217418,769
North Carolina,Guilford,98062,149248,10095,46896.0,257405,0.3809638507410501,-51186
North Carolina,Halifax,9031,15748,388,32549.0,25167,0.35884292923272537,-6717
North Carolina,Harnett,27614,16737,1714,47930.0,46065,0.5994572886139151,10877
North Carolina,Haywood,18929,10473,1325,43097.0,30727,0.6160380121717056,8456
North Carolina,Henderson,35809,19827,2540,48138.0,58176,0.6155287403740374,15982
North Carolina,Hertford,3099,6910,177,34523.0,10186,0.30424111525623404,-3811
North Carolina,Hoke,7760,9726,744,42704.0,18230,0.42567196928140427,-1966
North Carolina,Hyde,1288,965,51,37741.0,2304,0.5590277777777778,323
North Carolina,Iredell,54754,24734,3079,53937.0,82567,0.6631462933133092,30020
North Carolina,Jackson,9870,7713,1130,40278.0,18713,0.5274408165446481,2157
North Carolina,Johnston,54372,28362,3175,51980.0,85909,0.6329022570394255,26010
North Carolina,Jones,2974,2065,96,34080.0,5135,0.5791626095423564,909
North Carolina,Lee,13712,10469,903,46402.0,25084,0.5466432785839579,3243
North Carolina,Lenoir,13613,12634,560,36956.0,26807,0.5078151229156563,979
North Carolina,Lincoln,28806,9897,1320,49283.0,40023,0.7197361517127652,18909
North Carolina,McDowell,14568,4667,640,37590.0,19875,0.7329811320754717,9901
North Carolina,Macon,12127,4876,731,39593.0,17734,0.6838276756512913,7251
North Carolina,Madison,6783,3926,560,40408.0,11269,0.6019167628006035,2857
North Carolina,Martin,5897,5846,221,34957.0,11964,0.4928953527248412,51
North Carolina,Mecklenburg,155518,294562,22777,59268.0,472857,0.3288901295740573,-139044
North Carolina,Mitchell,6282,1596,218,39658.0,8096,0.7759387351778656,4686
North Carolina,Montgomery,7130,4150,260,34819.0,11540,0.6178509532062392,2980
North Carolina,Moore,30490,16329,1873,51873.0,48692,0.6261808921383389,14161
North Carolina,Nash,23319,23235,1111,43804.0,47665,0.4892268960453163,84
North Carolina,New Hanover,55344,50979,5582,51232.0,111905,0.49456235199499576,4365
North Carolina,Northampton,3582,6144,122,31543.0,9848,0.3637286758732738,-2562
North Carolina,Onslow,37122,17514,2499,46786.0,57135,0.6497243370963508,19608
North Carolina,Orange,18557,59923,3860,61130.0,82340,0.22537041535098373,-41366
North Carolina,Pamlico,4258,2448,164,43808.0,6870,0.6197962154294032,1810
North Carolina,Pasquotank,8180,8615,596,45750.0,17391,0.4703582312690472,-435
North Carolina,Pender,17639,9354,892,46580.0,27885,0.6325623094853864,8285
North Carolina,Perquimans,4177,2319,212,45208.0,6708,0.6226893261776982,1858
North Carolina,Person,11185,7833,597,43297.0,19615,0.5702268671934744,3352
North Carolina,Pitt,35691,41824,3012,42308.0,80527,0.443217802724552,-6133
North Carolina,Polk,6768,3735,431,47396.0,10934,0.6189866471556612,3033
North Carolina,Randolph,49430,13194,1951,43010.0,64575,0.7654665118079752,36236
North Carolina,Richmond,10383,8501,444,32526.0,19328,0.5371999172185431,1882
North Carolina,Robeson,20762,19016,1080,31298.0,40858,0.5081501786675804,1746
North Carolina,Rockingham,26830,14228,1220,40003.0,42278,0.6346090165097686,12602
North Carolina,Rowan,42810,19400,2159,44494.0,64369,0.6650716960027342,23410
North Carolina,Rutherford,21871,7512,924,36144.0,30307,0.7216484640512093,14359
North Carolina,Sampson,14838,10547,543,36742.0,25928,0.572277074976859,4291
North Carolina,Scotland,6256,7319,353,30013.0,13928,0.4491671453187823,-1063
North Carolina,Stanly,21964,7094,859,44140.0,29917,0.7341645218437678,14870
North Carolina,Stokes,17116,4665,769,42489.0,22550,0.7590243902439024,12451
North Carolina,Surry,23671,7488,1037,37345.0,32196,0.7352155547272953,16183
North Carolina,Swain,3565,2196,363,33598.0,6124,0.5821358589157414,1369
North Carolina,Transylvania,10520,6558,791,43918.0,17869,0.5887290838882981,3962
North Carolina,Tyrrell,975,720,44,32165.0,1739,0.5606670500287522,255
North Carolina,Union,66707,34337,4666,67194.0,105710,0.6310377447734368,32370
North Carolina,Vance,7332,12229,416,32733.0,19977,0.3670220753866947,-4897
North Carolina,Wake,196082,302736,28806,70620.0,527624,0.3716320713235183,-106654
North Carolina,Warren,3214,6413,215,33913.0,9842,0.32655964234911605,-3199
North Carolina,Washington,2564,3510,91,33286.0,6165,0.4158961881589619,-946
North Carolina,Watauga,13697,14138,2150,39443.0,29985,0.45679506419876603,-441
North Carolina,Wayne,27540,21770,1379,40457.0,50689,0.5433131448637771,5770
North Carolina,Wilkes,23752,6638,906,34846.0,31296,0.7589468302658486,17114
North Carolina,Wilson,17531,19663,941,40260.0,38135,0.4597089288055592,-2132
North Carolina,Yadkin,13880,3160,584,38623.0,17624,0.787562414888788,10720
North Carolina,Yancey,6385,3196,379,36993.0,9960,0.6410642570281124,3189
North Dakota,Adams,909,216,93,53295.0,1218,0.7463054187192119,693
North Dakota,Barnes,3160,1597,587,55778.0,5344,0.5913173652694611,1563
North Dakota,Benson,929,842,240,41530.0,2011,0.4619592242665341,87
North Dakota,Billings,495,59,51,67969.0,605,0.8181818181818182,436
North Dakota,Bottineau,2494,736,264,55958.0,3494,0.7137950772753291,1758
North Dakota,Bowman,1446,227,114,62955.0,1787,0.8091773922775601,1219
North Dakota,Burke,895,119,38,65521.0,1052,0.8507604562737643,776
North Dakota,Burleigh,32532,10881,4566,66057.0,47979,0.6780466454073657,21651
North Dakota,Cass,39816,31361,9644,54926.0,80821,0.49264423850236944,8455
North Dakota,Cavalier,1357,476,173,65645.0,2006,0.6764705882352942,881
North Dakota,Dickey,1667,554,186,55882.0,2407,0.692563356875779,1113
North Dakota,Divide,867,245,107,62470.0,1219,0.7112387202625102,622
North Dakota,Dunn,1771,358,114,66964.0,2243,0.7895675434685688,1413
North Dakota,Eddy,791,355,85,55489.0,1231,0.6425670186839968,436
North Dakota,Emmons,1677,215,89,45472.0,1981,0.8465421504290762,1462
North Dakota,Foster,1241,347,131,55625.0,1719,0.7219313554392088,894
North Dakota,Golden Valley,796,99,62,37014.0,957,0.831765935214211,697
North Dakota,Grand Forks,16340,10851,3174,50652.0,30365,0.5381195455293923,5489
North Dakota,Grant,1108,185,88,45978.0,1381,0.8023171614771905,923
North Dakota,Griggs,847,298,120,50250.0,1265,0.6695652173913044,549
North Dakota,Hettinger,1050,168,78,55230.0,1296,0.8101851851851852,882
North Dakota,Kidder,1111,179,86,58527.0,1376,0.8074127906976745,932
North Dakota,LaMoure,1481,502,168,55900.0,2151,0.6885169688516969,979
North Dakota,Logan,888,114,65,55068.0,1067,0.8322399250234301,774
North Dakota,McHenry,2050,490,280,60741.0,2820,0.7269503546099291,1560
North Dakota,McIntosh,1100,235,111,43650.0,1446,0.7607192254495159,865
North Dakota,McKenzie,3670,698,304,78179.0,4672,0.7855308219178082,2972
North Dakota,McLean,3860,1081,374,59976.0,5315,0.7262464722483537,2779
North Dakota,Mercer,3759,621,302,73801.0,4682,0.8028620247757369,3138
North Dakota,Morton,11336,3080,1416,63549.0,15832,0.7160181910055584,8256
North Dakota,Mountrail,2582,1220,304,68082.0,4106,0.6288358499756453,1362
North Dakota,Nelson,1025,536,156,51280.0,1717,0.5969714618520675,489
North Dakota,Oliver,830,119,68,66196.0,1017,0.816125860373648,711
North Dakota,Pembina,2208,681,264,56813.0,3153,0.7002854424357755,1527
North Dakota,Pierce,1437,431,203,43086.0,2071,0.6938676967648479,1006
North Dakota,Ramsey,3217,1505,583,50776.0,5305,0.6064090480678606,1712
North Dakota,Ransom,1210,838,311,57088.0,2359,0.512929207291225,372
North Dakota,Renville,993,201,99,65927.0,1293,0.7679814385150812,792
North Dakota,Richland,4767,2064,761,58125.0,7592,0.6278977871443625,2703
North Dakota,Rolette,1217,2099,439,37313.0,3755,0.3241011984021305,-882
North Dakota,Sargent,1088,694,215,57472.0,1997,0.5448172258387581,394
North Dakota,Sheridan,650,95,42,48375.0,787,0.8259212198221093,555
North Dakota,Sioux,260,758,214,39539.0,1232,0.21103896103896103,-498
North Dakota,Slope,362,43,25,58750.0,430,0.8418604651162791,319
North Dakota,Stark,9755,1753,814,76817.0,12322,0.7916734296380458,8002
North Dakota,Steele,538,361,100,58603.0,999,0.5385385385385385,177
North Dakota,Stutsman,6718,2498,939,53685.0,10155,0.6615460364352536,4220
North Dakota,Towner,733,305,119,53929.0,1157,0.6335350043215212,428
North Dakota,Traill,2265,1241,427,55764.0,3933,0.5758962623951183,1024
North Dakota,Walsh,2995,1167,474,51181.0,4636,0.6460310612597067,1828
North Dakota,Ward,18636,5806,2970,63037.0,27412,0.6798482416459944,12830
North Dakota,Wells,1796,419,168,50685.0,2383,0.7536718422156945,1377
North Dakota,Williams,10069,1735,1003,90080.0,12807,0.7862106660420083,8334
Ohio,Adams,8659,2326,374,34709.0,11359,0.7623030196320099,6333
Ohio,Allen,30487,13294,2113,45575.0,45894,0.6642916285353205,17193
Ohio,Ashland,17493,5740,1357,48509.0,24590,0.7113867425782838,11753
Ohio,Ashtabula,23318,15577,1972,41158.0,40867,0.5705826216751902,7741
Ohio,Athens,11354,16370,1719,34221.0,29443,0.38562646469449446,-5016
Ohio,Auglaize,18658,3980,989,55914.0,23627,0.7896897617132941,14678
Ohio,Belmont,21108,8785,1229,44719.0,31122,0.6782340466550992,12323
Ohio,Brown,14573,4353,681,47999.0,19607,0.7432549599632784,10220
Ohio,Butler,106976,58642,8221,59652.0,173839,0.615373995478575,48334
Ohio,Carroll,9254,3154,666,48545.0,13074,0.7078170414563255,6100
Ohio,Champaign,12631,4594,879,53673.0,18104,0.6976911179849757,8037
Ohio,Clark,35205,23328,2896,44154.0,61429,0.5731006527861433,11877
Ohio,Clermont,67518,26715,4888,61265.0,99121,0.6811674619909001,40803
Ohio,Clinton,13838,4066,771,48675.0,18675,0.7409906291834003,9772
Ohio,Columbiana,31676,12432,2093,45389.0,46201,0.6856128655223913,19244
Ohio,Coshocton,10785,4013,754,43380.0,15552,0.6934799382716049,6772
Ohio,Crawford,13611,4625,1001,40563.0,19237,0.7075427561470083,8986
Ohio,Cuyahoga,184211,398271,21340,45289.0,603822,0.3050750055479926,-214060
Ohio,Darke,20012,4470,1002,47043.0,25484,0.7852770365719667,15542
Ohio,Defiance,11688,5368,1136,50822.0,18192,0.6424802110817942,6320
Ohio,Delaware,57568,40872,5420,94234.0,103860,0.5542846139033314,16696
Ohio,Erie,19648,16057,1873,48276.0,37578,0.5228591196976955,3591
Ohio,Fairfield,44314,24881,3718,61473.0,72913,0.6077654190610727,19433
Ohio,Fayette,7995,2739,428,41954.0,11162,0.716269485755241,5256
Ohio,Franklin,199331,351198,30611,54037.0,581140,0.3429999655848849,-151867
Ohio,Fulton,13709,6069,1447,55860.0,21225,0.6458892815076561,7640
Ohio,Gallia,9822,2628,481,39423.0,12931,0.759570025520068,7194
Ohio,Geauga,30227,17569,2145,74165.0,49941,0.605254199955948,12658
Ohio,Greene,48540,28943,4375,61116.0,81858,0.5929780839991204,19597
Ohio,Guernsey,11445,4359,753,41566.0,16557,0.6912484145678565,7086
Ohio,Hamilton,173665,215719,19725,50399.0,409109,0.4244956723024915,-42054
Ohio,Hancock,24183,9609,2231,51604.0,36023,0.6713211004080726,14574
Ohio,Hardin,8717,2920,657,44842.0,12294,0.7090450626321783,5797
Ohio,Harrison,5098,1688,293,44000.0,7079,0.7201582144370674,3410
Ohio,Henry,9301,3756,875,54941.0,13932,0.6675997703129486,5545
Ohio,Highland,14020,3773,708,40593.0,18501,0.7577968758445489,10247
Ohio,Hocking,8497,3775,566,43382.0,12838,0.6618632185698707,4722
Ohio,Holmes,8720,1788,546,53619.0,11054,0.7888547132259816,6932
Ohio,Huron,16226,7192,1416,48838.0,24834,0.6533784327937505,9034
Ohio,Jackson,9949,3226,518,40330.0,13693,0.7265756225808807,6723
Ohio,Jefferson,21117,9675,1409,42327.0,32201,0.6557870873575354,11442
Ohio,Knox,19131,8171,1385,48619.0,28687,0.6668874403039704,10960
Ohio,Lake,64255,46397,5594,59958.0,116246,0.5527502021574936,17858
Ohio,Lawrence,18689,6974,944,44256.0,26607,0.7024091404517608,11715
Ohio,Licking,51241,27376,4144,57571.0,82761,0.619144282935199,23865
Ohio,Logan,15957,4647,967,51136.0,21571,0.7397431737054379,11310
Ohio,Lorain,66818,66949,6795,53459.0,140562,0.4753631849290704,-131
Ohio,Lucas,75698,110833,11025,42917.0,197556,0.38317236631638624,-35135
Ohio,Madison,11631,4779,880,58326.0,17290,0.672700983227299,6852
Ohio,Mahoning,53616,57381,4075,41872.0,115072,0.4659343715239155,-3765
Ohio,Marion,16961,7928,1433,43557.0,26322,0.6443659296406048,9033
Ohio,Medina,54810,32182,4381,69319.0,91373,0.5998489707025051,22628
Ohio,Meigs,7309,2260,416,39640.0,9985,0.7319979969954933,5049
Ohio,Mercer,17506,3384,836,55220.0,21726,0.8057626806591182,14122
Ohio,Miami,37079,13120,2535,53432.0,52734,0.703132703758486,23959
Ohio,Monroe,4868,1662,265,41368.0,6795,0.7164091243561442,3206
Ohio,Montgomery,123909,122016,12376,45394.0,258301,0.4797077827805545,1893
Ohio,Morgan,4431,1736,276,38941.0,6443,0.6877231103523204,2695
Ohio,Morrow,11948,3761,839,53032.0,16548,0.7220207880106357,8187
Ohio,Muskingum,24056,11123,1812,42464.0,36991,0.6503203481928037,12933
Ohio,Noble,4549,1221,243,41398.0,6013,0.756527523698653,3328
Ohio,Ottawa,12653,8285,1280,54580.0,22218,0.5694932037087046,4368
Ohio,Paulding,6500,2093,454,48003.0,9047,0.7184702111197082,4407
Ohio,Perry,10228,4138,629,43674.0,14995,0.6820940313437812,6090
Ohio,Pickaway,17076,6529,1140,58706.0,24745,0.6900788037987472,10547
Ohio,Pike,7902,3539,438,41128.0,11879,0.6652075090495833,4363
Ohio,Portage,39971,32397,3771,52427.0,76139,0.5249740605996926,7574
Ohio,Preble,15446,4325,794,51356.0,20565,0.751081935327012,11121
Ohio,Putnam,14961,2922,884,60245.0,18767,0.7971972078648691,12039
Ohio,Richland,36590,16085,2539,42849.0,55214,0.6626942442134242,20505
Ohio,Ross,18652,10356,1372,44587.0,30380,0.6139565503620803,8296
Ohio,Sandusky,16316,9929,1799,49032.0,28044,0.5818000285266011,6387
Ohio,Scioto,20550,9132,1102,37936.0,30784,0.6675545738045738,11418
Ohio,Seneca,14825,7404,1758,48415.0,23987,0.6180431066827865,7421
Ohio,Shelby,18590,4243,907,56169.0,23740,0.7830665543386689,14347
Ohio,Stark,98388,68146,8705,48714.0,175239,0.5614503620769349,30242
Ohio,Summit,112026,134256,11697,51562.0,257979,0.4342446478201714,-22230
Ohio,Trumbull,49024,43014,3991,43811.0,96029,0.5105124493642546,6010
Ohio,Tuscarawas,26918,12188,2183,46992.0,41289,0.651941194991402,14730
Ohio,Union,18096,7718,1615,71282.0,27429,0.6597396915673193,10378
Ohio,Van Wert,10469,2697,604,50547.0,13770,0.7602759622367465,7772
Ohio,Vinton,3883,1351,268,41080.0,5502,0.7057433660487096,2532
Ohio,Warren,77643,33730,5894,76200.0,117267,0.6621044283558034,43913
Ohio,Washington,20514,8026,1300,44763.0,29840,0.6874664879356568,12488
Ohio,Wayne,32270,15031,2552,51363.0,49853,0.6473030710288248,17239
Ohio,Williams,11939,4358,1011,45044.0,17308,0.6897966258377629,7581
Ohio,Wood,32498,27318,4525,55985.0,64341,0.5050900669868358,5180
Ohio,Wyandot,7468,2515,609,50723.0,10592,0.7050604229607251,4953
Oklahoma,Adair,4787,1382,344,33184.0,6513,0.7349915553508368,3405
Oklahoma,Alfalfa,1933,216,109,52226.0,2258,0.8560673162090345,1717
Oklahoma,Atoka,4084,795,139,36528.0,5018,0.8138700677560781,3289
Oklahoma,Beaver,1993,176,74,52908.0,2243,0.8885421310744539,1817
Oklahoma,Beckham,6308,960,284,48851.0,7552,0.8352754237288136,5348
Oklahoma,Blaine,2884,711,198,44216.0,3793,0.760348009491168,2173
Oklahoma,Bryan,10478,2804,536,39936.0,13818,0.7582862932407005,7674
Oklahoma,Caddo,6482,2420,446,40199.0,9348,0.6934103551561831,4062
Oklahoma,Canadian,39986,11674,3618,66664.0,55278,0.7233619161330005,28312
Oklahoma,Carter,13752,4002,780,46913.0,18534,0.7419876982842344,9750
Oklahoma,Cherokee,9994,5456,1040,38585.0,16490,0.6060642813826561,4538
Oklahoma,Choctaw,4206,1067,153,30870.0,5426,0.7751566531514928,3139
Oklahoma,Cimarron,963,71,45,44550.0,1079,0.8924930491195552,892
Oklahoma,Cleveland,62538,38829,8083,58488.0,109450,0.5713841936957514,23709
Oklahoma,Coal,1898,411,90,39231.0,2399,0.791162984576907,1487
Oklahoma,Comanche,19183,11463,1918,47238.0,32564,0.5890861073578184,7720
Oklahoma,Cotton,2054,424,124,48732.0,2602,0.7893927747886241,1630
Oklahoma,Craig,4283,1252,250,40036.0,5785,0.7403630077787381,3031
Oklahoma,Creek,21575,5841,1414,46517.0,28830,0.748352410683316,15734
Oklahoma,Custer,7826,2104,611,47250.0,10541,0.7424343041457168,5722
Oklahoma,Delaware,11826,3311,579,38438.0,15716,0.752481547467549,8515
Oklahoma,Dewey,1965,222,61,51654.0,2248,0.8741103202846975,1743
Oklahoma,Ellis,1611,155,61,52222.0,1827,0.8817733990147784,1456
Oklahoma,Garfield,16009,4397,1304,49675.0,21710,0.7374021188392446,11612
Oklahoma,Garvin,8253,1855,438,41250.0,10546,0.782571591124597,6398
Oklahoma,Grady,17316,3882,1088,54043.0,22286,0.7769900385892489,13434
Oklahoma,Grant,1827,288,86,54040.0,2201,0.830077237619264,1539
Oklahoma,Greer,1482,323,91,36891.0,1896,0.7816455696202531,1159
Oklahoma,Harmon,715,225,37,35676.0,977,0.7318321392016377,490
Oklahoma,Harper,1318,134,47,48173.0,1499,0.8792528352234823,1184
Oklahoma,Haskell,3701,882,155,36067.0,4738,0.7811312790206838,2819
Oklahoma,Hughes,3388,961,177,35257.0,4526,0.7485638532920902,2427
Oklahoma,Jackson,5969,1473,364,44331.0,7806,0.7646682039456828,4496
Oklahoma,Jefferson,1910,365,75,35063.0,2350,0.8127659574468085,1545
Oklahoma,Johnston,3093,786,139,38155.0,4018,0.7697859631657541,2307
Oklahoma,Kay,12172,3738,893,42831.0,16803,0.7243944533714217,8434
Oklahoma,Kingfisher,5156,786,189,62912.0,6131,0.8409721089544936,4370
Oklahoma,Kiowa,2596,767,130,38853.0,3493,0.7432006870884627,1829
Oklahoma,Latimer,3100,797,159,39701.0,4056,0.7642998027613412,2303
Oklahoma,Le Flore,13362,3250,609,37548.0,17221,0.7759131293188549,10112
Oklahoma,Lincoln,10854,2430,741,46592.0,14025,0.773903743315508,8424
Oklahoma,Logan,13633,4248,1098,55698.0,18979,0.718320248695927,9385
Oklahoma,Love,2922,735,132,46646.0,3789,0.7711797307996833,2187
Oklahoma,McClain,13169,2894,795,58673.0,16858,0.7811721437892989,10275
Oklahoma,McCurtain,8656,1802,268,33439.0,10726,0.8070110013052396,6854
Oklahoma,McIntosh,5505,2123,335,36878.0,7963,0.691322365942484,3382
Oklahoma,Major,2948,310,149,51602.0,3407,0.8652773701203404,2638
Oklahoma,Marshall,4206,1096,190,42886.0,5492,0.7658412235979607,3110
Oklahoma,Mayes,11555,3423,739,43302.0,15717,0.7351911942482662,8132
Oklahoma,Murray,4175,1087,266,51752.0,5528,0.755246020260492,3088
Oklahoma,Muskogee,15043,7977,1196,41117.0,24216,0.6212008589362406,7066
Oklahoma,Noble,3715,901,262,49367.0,4878,0.7615826158261583,2814
Oklahoma,Nowata,3321,742,174,40302.0,4237,0.7838092990323342,2579
Oklahoma,Okfuskee,2800,943,200,36044.0,3943,0.7101191985797616,1857
Oklahoma,Oklahoma,141569,112813,19560,48987.0,273942,0.5167845748370093,28756
Oklahoma,Okmulgee,8944,4385,620,38712.0,13949,0.641192917054986,4559
Oklahoma,Osage,12577,5597,792,46342.0,18966,0.6631340293156174,6980
Oklahoma,Ottawa,7631,2584,475,37139.0,10690,0.713844714686623,5047
Oklahoma,Pawnee,4729,1344,291,45902.0,6364,0.7430861093651792,3385
Oklahoma,Payne,16651,8788,2321,38085.0,27760,0.5998198847262248,7863
Oklahoma,Pittsburg,12753,3711,807,43601.0,17271,0.7384054194893174,9042
Oklahoma,Pontotoc,10431,3637,763,44041.0,14831,0.7033241184006473,6794
Oklahoma,Pottawatomie,17848,6015,1589,44351.0,25452,0.7012415527267012,11833
Oklahoma,Pushmataha,3581,748,154,33784.0,4483,0.7987954494757975,2833
Oklahoma,Roger Mills,1547,151,61,48462.0,1759,0.8794769755542922,1396
Oklahoma,Rogers,30913,7902,2047,59828.0,40862,0.7565219519357839,23011
Oklahoma,Seminole,5613,2071,353,36870.0,8037,0.6983949234789101,3542
Oklahoma,Sequoyah,10888,3061,488,36301.0,14437,0.7541733047031932,7827
Oklahoma,Stephens,14182,3086,636,43493.0,17904,0.7921134941912422,11096
Oklahoma,Texas,4621,858,301,51503.0,5780,0.7994809688581315,3763
Oklahoma,Tillman,1944,657,105,37880.0,2706,0.7184035476718403,1287
Oklahoma,Tulsa,144258,87847,14949,50654.0,247054,0.5839128287742761,56411
Oklahoma,Wagoner,23005,6723,1572,57590.0,31300,0.7349840255591055,16282
Oklahoma,Washington,15825,5048,1351,50038.0,22224,0.7120680345572354,10777
Oklahoma,Washita,3854,588,189,48715.0,4631,0.8322176635715828,3266
Oklahoma,Woods,2947,522,199,57079.0,3668,0.8034351145038168,2425
Oklahoma,Woodward,6347,873,375,58569.0,7595,0.8356813693219223,5474
Oregon,Baker,6218,1797,764,41722.0,8779,0.7082811254129172,4421
Oregon,Benton,13445,29193,6115,52015.0,48753,0.27577790084712733,-15748
Oregon,Clackamas,88392,102095,23552,68915.0,214039,0.41297146781661287,-13703
Oregon,Clatsop,8138,9252,2274,47492.0,19664,0.41385272579332794,-1114
Oregon,Columbia,13217,10167,3234,55146.0,26618,0.49654369223833494,3050
Oregon,Coos,17865,10448,3000,39110.0,31313,0.5705298118992111,7417
Oregon,Crook,8511,2637,1024,39583.0,12172,0.6992277357870522,5874
Oregon,Curry,7212,4300,1099,38661.0,12611,0.5718816905875823,2912
Oregon,Deschutes,45692,42444,10421,54211.0,98557,0.46360989072313485,3248
Oregon,Douglas,34582,14096,4843,42052.0,53521,0.6461388987500234,20486
Oregon,Gilliam,671,239,109,40556.0,1019,0.6584887144259077,432
Oregon,Grant,3210,739,391,40193.0,4340,0.7396313364055299,2471
Oregon,Harney,2912,683,379,38431.0,3974,0.7327629592350277,2229
Oregon,Hood River,3272,6510,1128,56581.0,10910,0.2999083409715857,-3238
Oregon,Jackson,53870,44447,11010,46343.0,109327,0.49274195761339834,9423
Oregon,Jefferson,5483,2980,996,47063.0,9459,0.5796595834654826,2503
Oregon,Josephine,26923,13453,4184,37867.0,44560,0.6041965888689408,13470
Oregon,Klamath,20435,7210,2862,41951.0,30507,0.6698462647916872,13225
Oregon,Lake,3022,639,269,33453.0,3930,0.7689567430025446,2383
Oregon,Lane,67141,102753,22056,45222.0,191950,0.3497837978640271,-35612
Oregon,Lincoln,10039,12501,2716,41303.0,25256,0.39748970541653467,-2462
Oregon,Linn,33488,17995,7236,46782.0,58719,0.5703094398746573,15493
Oregon,Malheur,7194,2246,995,34720.0,10435,0.68941063727839,4948
Oregon,Marion,63377,57788,15675,50775.0,136840,0.463146740719088,5589
Oregon,Morrow,2721,1017,429,54441.0,4167,0.6529877609791217,1704
Oregon,Multnomah,67954,292561,38588,57449.0,399103,0.17026682335136545,-224607
Oregon,Polk,18940,16420,4935,54010.0,40295,0.47003350291599455,2520
Oregon,Sherman,732,202,83,41389.0,1017,0.7197640117994101,530
Oregon,Tillamook,6538,5768,1497,43777.0,13803,0.4736651452582772,770
Oregon,Umatilla,17059,7673,2865,49287.0,27597,0.6181469000253651,9386
Oregon,Union,8431,3249,1288,45564.0,12968,0.6501388032078964,5182
Oregon,Wallowa,2848,1116,402,42349.0,4366,0.652313330279432,1732
Oregon,Wasco,5833,4781,1350,46814.0,11964,0.48754597124707455,1052
Oregon,Washington,83197,153251,32784,69743.0,269232,0.30901601592678435,-70054
Oregon,Wheeler,591,155,72,33400.0,818,0.7224938875305623,436
Oregon,Yamhill,23250,19301,6202,54951.0,48753,0.47689372961663895,3949
Pennsylvania,Adams,31423,14219,1847,61927.0,47489,0.6616900755964539,17204
Pennsylvania,Allegheny,259480,367617,23017,54357.0,650114,0.39912999873868277,-108137
Pennsylvania,Armstrong,23484,7178,956,45879.0,31618,0.7427414763742172,16306
Pennsylvania,Beaver,48167,32531,2873,51887.0,83571,0.5763602206507042,15636
Pennsylvania,Bedford,19552,3645,440,46746.0,23637,0.8271777298303508,15907
Pennsylvania,Berks,96626,78437,8002,57068.0,183065,0.5278234506869145,18189
Pennsylvania,Blair,39135,13958,1816,44033.0,54909,0.7127246899415396,25177
Pennsylvania,Bradford,18141,6369,1198,51035.0,25708,0.7056558269799285,11772
Pennsylvania,Bucks,164361,167060,12876,79559.0,344297,0.47738144683224076,-2699
Pennsylvania,Butler,64428,28584,4059,63345.0,97071,0.6637203696263559,35844
Pennsylvania,Cambria,42258,18867,1947,42917.0,63072,0.669996194824962,23391
Pennsylvania,Cameron,1589,531,66,40347.0,2186,0.7268984446477584,1058
Pennsylvania,Carbon,18743,8936,1097,50822.0,28776,0.6513413956074506,9807
Pennsylvania,Centre,35274,37088,3786,54407.0,76148,0.4632295004464989,-1814
Pennsylvania,Chester,116114,141682,11004,88995.0,268800,0.4319717261904762,-25568
Pennsylvania,Clarion,12576,4273,686,42890.0,17535,0.7171941830624465,8303
Pennsylvania,Clearfield,24932,8200,1139,43361.0,34271,0.7274955501736162,16732
Pennsylvania,Clinton,10022,4744,628,47163.0,15394,0.651032869949331,5278
Pennsylvania,Columbia,18004,8934,1290,46952.0,28228,0.6378064333286099,9070
Pennsylvania,Crawford,24987,10971,1534,45637.0,37492,0.666462178598101,14016
Pennsylvania,Cumberland,69076,47085,5456,62640.0,121617,0.5679798054548295,21991
Pennsylvania,Dauphin,60863,64706,5303,54968.0,130872,0.46505746072498316,-3843
Pennsylvania,Delaware,110667,177402,9565,66576.0,297634,0.37182243964063244,-66735
Pennsylvania,Elk,10025,3853,548,47917.0,14426,0.6949258283654512,6172
Pennsylvania,Erie,60069,58112,5498,47094.0,123679,0.48568471607952846,1957
Pennsylvania,Fayette,34590,17946,1231,40511.0,53767,0.6433314114605613,16644
Pennsylvania,Forest,1683,626,92,36594.0,2401,0.7009579341940858,1057
Pennsylvania,Franklin,49768,17465,2498,55751.0,69731,0.7137141300139106,32303
Pennsylvania,Fulton,5694,912,165,49420.0,6771,0.8409392999556934,4782
Pennsylvania,Greene,10849,4482,433,49116.0,15764,0.6882136513575234,6367
Pennsylvania,Huntingdon,14494,4539,673,45250.0,19706,0.7355120267938698,9955
Pennsylvania,Indiana,24888,11528,1354,45118.0,37770,0.6589356632247816,13360
Pennsylvania,Jefferson,15192,3650,636,43913.0,19478,0.7799568744224253,11542
Pennsylvania,Juniata,8273,1821,360,49028.0,10454,0.7913717237421083,6452
Pennsylvania,Lackawanna,48384,51983,3089,46673.0,103456,0.4676770801113517,-3599
Pennsylvania,Lancaster,137914,91093,12105,59237.0,241112,0.5719914396628952,46821
Pennsylvania,Lawrence,25428,14009,1316,45764.0,40753,0.6239540647314308,11419
Pennsylvania,Lebanon,40525,18953,2367,56191.0,61845,0.6552672002587113,21572
Pennsylvania,Lehigh,73690,81324,5979,57685.0,160993,0.4577217643003112,-7634
Pennsylvania,Luzerne,78688,52451,3844,46577.0,134983,0.5829474822755458,26237
Pennsylvania,Lycoming,35627,13020,1918,48731.0,50565,0.7045782655987343,22607
Pennsylvania,McKean,11635,4025,636,44023.0,16296,0.7139788905252823,7610
Pennsylvania,Mercer,31544,18733,2032,45831.0,52309,0.6030319830239538,12811
Pennsylvania,Mifflin,14094,3877,630,42019.0,18601,0.7577011988602763,10217
Pennsylvania,Monroe,33386,33918,2448,58980.0,69752,0.47863860534464964,-532
Pennsylvania,Montgomery,162731,256082,15874,81902.0,434687,0.3743636225606011,-93351
Pennsylvania,Montour,5288,2857,411,55233.0,8556,0.6180458158017765,2431
Pennsylvania,Northampton,71736,66272,5511,62753.0,143519,0.49983625861384207,5464
Pennsylvania,Northumberland,25427,9788,1407,43701.0,36622,0.6943094314892687,15639
Pennsylvania,Perry,15616,4632,910,58585.0,21158,0.7380659797712449,10984
Pennsylvania,Philadelphia,108748,584025,14858,39770.0,707631,0.15367896544950688,-475277
Pennsylvania,Pike,16056,9256,789,61199.0,26101,0.615148844871844,6800
Pennsylvania,Potter,6251,1302,231,40921.0,7784,0.8030575539568345,4949
Pennsylvania,Schuylkill,44001,16770,2098,46573.0,62869,0.6998838855397732,27231
Pennsylvania,Snyder,11725,4002,636,51110.0,16363,0.7165556438305934,7723
Pennsylvania,Somerset,27379,7376,1018,45424.0,35773,0.7653537584211556,20003
Pennsylvania,Sullivan,2291,750,95,44926.0,3136,0.7305484693877551,1541
Pennsylvania,Susquehanna,12891,5123,849,50160.0,18863,0.6834013677569846,7768
Pennsylvania,Tioga,13614,3901,810,48449.0,18325,0.7429195088676671,9713
Pennsylvania,Union,10622,6180,666,51349.0,17468,0.6080833524158461,4442
Pennsylvania,Venango,16021,6309,1018,43885.0,23348,0.6861829707041288,9712
Pennsylvania,Warren,12477,5145,812,44977.0,18434,0.6768471303027015,7332
Pennsylvania,Washington,61386,36322,3742,57534.0,101450,0.605086249383933,25064
Pennsylvania,Wayne,16244,7008,766,50595.0,24018,0.6763260887667583,9236
Pennsylvania,Westmoreland,116522,59669,5860,54142.0,182051,0.6400514141641628,56853
Pennsylvania,Wyoming,8837,3811,496,53397.0,13144,0.6723219720024346,5026
Pennsylvania,York,128528,68524,8934,59853.0,205986,0.623964735467459,60004
Rhode Island,Bristol,8965,14609,1901,73096.0,25475,0.35191364082433757,-5644
Rhode Island,Kent,38336,37788,5929,65592.0,82053,0.4672102177860651,548
Rhode Island,Newport,15077,22851,3117,71347.0,41045,0.36732854184431724,-7774
Rhode Island,Providence,90882,142899,14693,50637.0,248474,0.36576060271899674,-52017
Rhode Island,Washington,27230,33741,5398,74302.0,66369,0.41028190872244574,-6511
South Carolina,Abbeville,6763,3741,271,34652.0,10775,0.6276566125290023,3022
South Carolina,Aiken,46025,25455,3371,46454.0,74851,0.6148882446460301,20570
South Carolina,Allendale,789,2735,68,24817.0,3592,0.21965478841870825,-1946
South Carolina,Anderson,56232,21097,3154,43518.0,80483,0.6986817091808208,35135
South Carolina,Bamberg,2204,3898,112,32321.0,6214,0.35468297392983583,-1694
South Carolina,Barnwell,4889,4400,196,34787.0,9485,0.5154454401686874,489
South Carolina,Beaufort,42922,32138,3464,59227.0,78524,0.5466099536447455,10784
South Carolina,Berkeley,44587,30705,4225,54484.0,79517,0.56072286429317,13882
South Carolina,Calhoun,3787,3573,189,42779.0,7549,0.5016558484567493,214
South Carolina,Charleston,75443,89299,11603,54931.0,176345,0.4278147948623437,-13856
South Carolina,Cherokee,15167,6092,500,35719.0,21759,0.6970449009605221,9075
South Carolina,Chester,7265,6579,348,34319.0,14192,0.5119081172491544,686
South Carolina,Chesterfield,9312,6858,411,35733.0,16581,0.5616066582232676,2454
South Carolina,Clarendon,7386,7732,277,34106.0,15395,0.47976615784345567,-346
South Carolina,Colleton,9091,7627,533,33918.0,17251,0.5269839429598284,1464
South Carolina,Darlington,14989,13888,797,34773.0,29674,0.5051223293118555,1101
South Carolina,Dillon,5637,5834,227,30955.0,11698,0.48187724397332876,-197
South Carolina,Dorchester,34987,24055,3525,56345.0,62567,0.5591925455911263,10932
South Carolina,Edgefield,6842,4491,311,48114.0,11644,0.5875987633115768,2351
South Carolina,Fairfield,4027,6945,295,33798.0,11267,0.3574154610810331,-2918
South Carolina,Florence,29573,26710,1648,42523.0,57931,0.5104866133848889,2863
South Carolina,Georgetown,17389,13310,958,45299.0,31657,0.5492939950090028,4079
South Carolina,Greenville,127832,74483,12850,51595.0,215165,0.5941114958287825,53349
South Carolina,Greenwood,16961,10711,1091,37631.0,28763,0.5896811876368946,6250
South Carolina,Hampton,3488,5170,148,31734.0,8806,0.3960935725641608,-1682
South Carolina,Horry,89288,39410,4222,44746.0,132920,0.6717424014444778,49878
South Carolina,Jasper,5187,5956,284,38991.0,11427,0.4539249146757679,-769
South Carolina,Kershaw,17542,10330,1123,46328.0,28995,0.6050008622176237,7212
South Carolina,Lancaster,23719,13812,1407,46852.0,38938,0.6091478761107402,9907
South Carolina,Laurens,16816,8889,861,39848.0,26566,0.6329895354964993,7927
South Carolina,Lee,2803,5199,154,31169.0,8156,0.3436733692986758,-2396
South Carolina,Lexington,80026,35230,6837,55412.0,122093,0.65545117246689,44796
South Carolina,McCormick,2652,2479,85,41029.0,5216,0.5084355828220859,173
South Carolina,Marion,5444,8569,263,30562.0,14276,0.3813393107312973,-3125
South Carolina,Marlboro,4267,5954,168,32601.0,10389,0.4107228799691982,-1687
South Carolina,Newberry,10017,6217,573,39841.0,16807,0.5960016659725115,3800
South Carolina,Oconee,24178,7998,1459,41818.0,33635,0.7188345473465141,16180
South Carolina,Orangeburg,11931,26318,661,34763.0,38910,0.3066306861989206,-14387
South Carolina,Pickens,36236,10354,2459,43531.0,49049,0.7387714326489837,25882
South Carolina,Richland,52469,108000,8253,50899.0,168722,0.31097900688706864,-55531
South Carolina,Saluda,5526,2813,225,41458.0,8564,0.6452592246613732,2713
South Carolina,Spartanburg,76277,39997,4816,45219.0,121090,0.6299198942935007,36280
South Carolina,Sumter,18745,24047,1294,40777.0,44086,0.42519167082520526,-5302
South Carolina,Union,7061,4729,302,34953.0,12092,0.5839397949057228,2332
South Carolina,Williamsburg,4864,9953,237,28494.0,15054,0.32310349408795,-5089
South Carolina,York,66754,41593,6010,56482.0,114357,0.5837333962940616,25161
South Dakota,Aurora,974,340,93,52620.0,1407,0.6922530206112296,634
South Dakota,Beadle,4455,1912,405,48423.0,6772,0.6578558771411696,2543
South Dakota,Bennett,666,412,71,45820.0,1149,0.5796344647519582,254
South Dakota,Bon Homme,2105,704,165,48023.0,2974,0.7078009414929388,1401
South Dakota,Brookings,6748,4879,1053,52086.0,12680,0.5321766561514195,1869
South Dakota,Brown,9613,5452,1049,53073.0,16114,0.596561995780067,4161
South Dakota,Brule,1565,571,152,50696.0,2288,0.6840034965034965,994
South Dakota,Buffalo,171,296,23,31293.0,490,0.3489795918367347,-125
South Dakota,Butte,3357,696,298,43750.0,4351,0.7715467708572742,2661
South Dakota,Campbell,704,105,22,45800.0,831,0.8471720818291215,599
South Dakota,Charles Mix,2382,935,116,43376.0,3433,0.6938537722108943,1447
South Dakota,Clark,1139,398,120,48563.0,1657,0.6873868436934218,741
South Dakota,Clay,2109,2608,352,38399.0,5069,0.41605839416058393,-499
South Dakota,Codington,7764,3174,731,50133.0,11669,0.6653526437569629,4590
South Dakota,Corson,588,535,52,32115.0,1175,0.5004255319148936,53
South Dakota,Custer,3293,1121,307,52891.0,4721,0.6975217115018004,2172
South Dakota,Davison,5157,2355,440,48310.0,7952,0.6485160965794768,2802
South Dakota,Day,1627,974,146,40647.0,2747,0.592282489989079,653
South Dakota,Deuel,1366,570,144,54781.0,2080,0.6567307692307692,796
South Dakota,Dewey,723,888,97,40585.0,1708,0.42330210772833726,-165
South Dakota,Douglas,1338,214,53,51290.0,1605,0.8336448598130841,1124
South Dakota,Edmunds,1433,380,105,62467.0,1918,0.7471324296141815,1053
South Dakota,Fall River,2511,821,231,45750.0,3563,0.7047431939376929,1690
South Dakota,Faulk,858,204,56,43529.0,1118,0.7674418604651163,654
South Dakota,Grant,2382,971,211,54180.0,3564,0.6683501683501684,1411
South Dakota,Gregory,1600,391,100,40045.0,2091,0.7651841224294595,1209
South Dakota,Haakon,936,77,31,39554.0,1044,0.896551724137931,859
South Dakota,Hamlin,2051,555,156,60169.0,2762,0.7425778421433744,1496
South Dakota,Hand,1391,334,93,52266.0,1818,0.7651265126512651,1057
South Dakota,Hanson,1497,424,85,60089.0,2006,0.7462612163509471,1073
South Dakota,Harding,695,38,37,51458.0,770,0.9025974025974026,657
South Dakota,Hughes,5174,2450,551,58934.0,8175,0.6329051987767584,2724
South Dakota,Hutchinson,2517,692,156,47356.0,3365,0.7479940564635958,1825
South Dakota,Hyde,543,125,22,55000.0,690,0.7869565217391304,418
South Dakota,Jackson,722,323,50,41510.0,1095,0.6593607305936073,399
South Dakota,Jerauld,648,264,55,51442.0,967,0.6701137538779731,384
South Dakota,Jones,450,69,39,39276.0,558,0.8064516129032258,381
South Dakota,Kingsbury,1680,703,168,54568.0,2551,0.6585652685221481,977
South Dakota,Lake,4038,2314,434,57239.0,6786,0.5950486295313882,1724
South Dakota,Lawrence,7411,3356,1075,48220.0,11842,0.6258233406519169,4055
South Dakota,Lincoln,15499,8076,1656,77455.0,25231,0.6142840156949784,7423
South Dakota,Lyman,977,369,75,45921.0,1421,0.6875439831104856,608
South Dakota,McCook,1794,623,170,58485.0,2587,0.6934673366834171,1171
South Dakota,McPherson,892,192,53,41338.0,1137,0.7845206684256816,700
South Dakota,Marshall,1056,754,137,55398.0,1947,0.5423728813559322,302
South Dakota,Meade,8441,2223,957,53069.0,11621,0.7263574563290595,6218
South Dakota,Mellette,402,238,43,29471.0,683,0.5885797950219619,164
South Dakota,Miner,706,281,77,48542.0,1064,0.6635338345864662,425
South Dakota,Minnehaha,42043,30610,5610,55293.0,78263,0.5372014872928459,11433
South Dakota,Moody,1731,1043,159,54383.0,2933,0.59018070235254,688
South Dakota,Pennington,29804,14074,3865,51084.0,47743,0.6242590536832625,15730
South Dakota,Perkins,1333,188,85,45855.0,1606,0.8300124533001245,1145
South Dakota,Potter,1071,215,51,47991.0,1337,0.8010471204188482,856
South Dakota,Roberts,2144,1540,205,50108.0,3889,0.5512985343275907,604
South Dakota,Sanborn,819,241,63,51167.0,1123,0.7292965271593945,578
South Dakota,Oglala Lakota,241,2510,154,30000.0,2905,0.08296041308089501,-2269
South Dakota,Spink,1854,919,178,49859.0,2951,0.6282616062351745,935
South Dakota,Stanley,1148,329,90,60046.0,1567,0.7326100829610721,819
South Dakota,Sully,679,137,45,59800.0,861,0.7886178861788617,542
South Dakota,Todd,487,1505,133,30800.0,2125,0.2291764705882353,-1018
South Dakota,Tripp,2069,462,99,41210.0,2630,0.7866920152091255,1607
South Dakota,Turner,2937,961,252,54707.0,4150,0.707710843373494,1976
South Dakota,Union,5290,2227,380,63890.0,7897,0.6698746359376979,3063
South Dakota,Walworth,1896,457,124,46526.0,2477,0.7654420670165523,1439
South Dakota,Yankton,5659,3301,663,48723.0,9623,0.5880702483632962,2358
South Dakota,Ziebach,368,353,46,36552.0,767,0.47979139504563234,15
Tennessee,Anderson,19212,9013,1656,44241.0,29881,0.6429503698002075,10199
Tennessee,Bedford,11486,3395,474,43819.0,15355,0.7480299576685119,8091
Tennessee,Benton,4716,1474,138,33611.0,6328,0.7452591656131479,3242
Tennessee,Bledsoe,3622,897,145,38535.0,4664,0.7765866209262435,2725
Tennessee,Blount,37443,12100,2665,49532.0,52208,0.7171889365614466,25343
Tennessee,Bradley,29768,7070,1828,43721.0,38666,0.769875342678322,22698
Tennessee,Campbell,9870,2248,414,33628.0,12532,0.7875837855090967,7622
Tennessee,Cannon,4007,1127,180,43654.0,5314,0.7540459164471208,2880
Tennessee,Carroll,7756,2327,301,36212.0,10384,0.7469183359013868,5429
Tennessee,Carter,16898,3453,733,33177.0,21084,0.8014608233731739,13445
Tennessee,Cheatham,11297,3878,749,53179.0,15924,0.7094323034413464,7419
Tennessee,Chester,5081,1243,183,42376.0,6507,0.7808513908098971,3838
Tennessee,Claiborne,8602,1832,306,33428.0,10740,0.8009310986964618,6770
Tennessee,Clay,2141,707,72,28147.0,2920,0.7332191780821918,1434
Tennessee,Cocke,9791,1981,354,31081.0,12126,0.8074385617681016,7810
Tennessee,Coffee,14417,4743,811,45456.0,19971,0.7218967502879174,9674
Tennessee,Crockett,3982,1303,112,38043.0,5397,0.7378173059106912,2679
Tennessee,Cumberland,20413,5202,745,40123.0,26360,0.7743930197268589,15211
Tennessee,Davidson,84550,148864,15654,50484.0,249068,0.3394655274864696,-64314
Tennessee,Decatur,3588,894,110,38180.0,4592,0.7813588850174216,2694
Tennessee,DeKalb,5171,1569,215,37640.0,6955,0.7434938892882819,3602
Tennessee,Dickson,13233,4722,744,47137.0,18699,0.7076849029359858,8511
Tennessee,Dyer,10180,2816,340,42833.0,13336,0.7633473305338933,7364
Tennessee,Fayette,13055,5874,465,55972.0,19394,0.6731463339177065,7181
Tennessee,Fentress,6038,1100,195,31714.0,7333,0.8234010636847129,4938
Tennessee,Franklin,11532,4374,498,44837.0,16404,0.7029992684711046,7158
Tennessee,Gibson,13786,5258,503,38854.0,19547,0.7052744666700772,8528
Tennessee,Giles,7970,2917,250,40635.0,11137,0.7156325760976924,5053
Tennessee,Grainger,6626,1154,228,37522.0,8008,0.8274225774225774,5472
Tennessee,Greene,18562,4216,805,36711.0,23583,0.7870923970656829,14346
Tennessee,Grundy,3636,999,128,28467.0,4763,0.7633844215830359,2637
Tennessee,Hamblen,15857,4075,760,39270.0,20692,0.7663348153875894,11782
Tennessee,Hamilton,78733,55316,8359,49434.0,142408,0.5528692208302904,23417
Tennessee,Hancock,1843,322,66,27973.0,2231,0.8260869565217391,1521
Tennessee,Hardeman,4919,4185,169,33566.0,9273,0.5304647902512671,734
Tennessee,Hardin,8012,1622,315,37244.0,9949,0.8053070660367876,6390
Tennessee,Hawkins,16648,3507,619,37883.0,20774,0.8013863483200154,13141
Tennessee,Haywood,3013,3711,110,35094.0,6834,0.4408838162130524,-698
Tennessee,Henderson,8138,1800,279,41478.0,10217,0.796515611236175,6338
Tennessee,Henry,9508,3063,374,38378.0,12945,0.7344920818848977,6445
Tennessee,Hickman,5695,1824,294,37546.0,7813,0.728913349545629,3871
Tennessee,Houston,2182,866,120,40680.0,3168,0.6887626262626263,1316
Tennessee,Humphreys,4930,1967,256,40995.0,7153,0.689221305745841,2963
Tennessee,Jackson,3236,1129,101,32676.0,4466,0.7245857590685177,2107
Tennessee,Jefferson,14776,3494,802,43673.0,19072,0.774748322147651,11282
Tennessee,Johnson,5410,988,181,30180.0,6579,0.8223134214926281,4422
Tennessee,Knox,105767,62878,12052,50366.0,180697,0.5853279246473378,42889
Tennessee,Lake,1357,577,36,29893.0,1970,0.6888324873096446,780
Tennessee,Lauderdale,4884,3056,147,32353.0,8087,0.6039322369234574,1828
Tennessee,Lawrence,12420,2821,425,40457.0,15666,0.7927996936039832,9599
Tennessee,Lewis,3585,890,147,36920.0,4622,0.7756382518390307,2695
Tennessee,Lincoln,10398,2554,396,41038.0,13348,0.7789931075816602,7844
Tennessee,Loudon,17610,4919,862,52995.0,23391,0.7528536616647429,12691
Tennessee,McMinn,14691,3510,554,38661.0,18755,0.7833111170354572,11181
Tennessee,McNairy,7841,1848,349,31956.0,10038,0.7811316995417413,5993
Tennessee,Macon,6263,1072,169,34098.0,7504,0.8346215351812367,5191
Tennessee,Madison,21335,15448,1337,44237.0,38120,0.5596799580272823,5887
Tennessee,Marion,7696,2832,334,41477.0,10862,0.708525133492911,4864
Tennessee,Marshall,8184,2852,419,44900.0,11455,0.7144478393714535,5332
Tennessee,Maury,23799,10038,1532,49597.0,35369,0.6728773784952925,13761
Tennessee,Meigs,3342,856,122,35209.0,4320,0.7736111111111111,2486
Tennessee,Monroe,13374,3186,533,37054.0,17093,0.7824255543204821,10188
Tennessee,Montgomery,32341,21699,3580,51528.0,57620,0.5612808052759458,10642
Tennessee,Moore,2325,496,105,49496.0,2926,0.7946001367053999,1829
Tennessee,Morgan,5441,1054,210,39728.0,6705,0.8114839671886652,4387
Tennessee,Obion,9526,2426,297,38933.0,12249,0.7776961384602825,7100
Tennessee,Overton,6059,1945,225,35065.0,8229,0.7362984566776036,4114
Tennessee,Perry,2167,597,91,31274.0,2855,0.7590192644483362,1570
Tennessee,Pickett,2021,536,58,39014.0,2615,0.772848948374761,1485
Tennessee,Polk,5097,1252,171,41520.0,6520,0.7817484662576687,3845
Tennessee,Putnam,19002,6851,1359,36350.0,27212,0.6982948699103336,12151
Tennessee,Rhea,8660,1942,460,38355.0,11062,0.7828602422708371,6718
Tennessee,Roane,15880,4837,952,42299.0,21669,0.7328441552448198,11043
Tennessee,Robertson,19410,6637,1066,56331.0,27113,0.71589274517759,12773
Tennessee,Rutherford,64515,36706,6215,58032.0,107436,0.6004970400982911,27809
Tennessee,Scott,6044,934,145,30897.0,7123,0.8485188824933315,5110
Tennessee,Sequatchie,4441,1053,200,46541.0,5694,0.7799438004917457,3388
Tennessee,Sevier,28629,6297,1386,42586.0,36312,0.788417052214144,22332
Tennessee,Shelby,116344,208992,12047,46854.0,337383,0.3448425083658631,-92648
Tennessee,Smith,5494,1689,253,44272.0,7436,0.7388380849919312,3805
Tennessee,Stewart,3864,1222,213,41835.0,5299,0.7291941875825627,2642
Tennessee,Sullivan,46979,12578,2721,40983.0,62278,0.7543434278557436,34401
Tennessee,Sumner,50129,18161,3215,58972.0,71505,0.7010558702188658,31968
Tennessee,Tipton,16910,5785,786,54650.0,23481,0.7201567224564541,11125
Tennessee,Trousdale,2103,946,111,47667.0,3160,0.665506329113924,1157
Tennessee,Unicoi,5671,1262,262,35390.0,7195,0.7881862404447533,4409
Tennessee,Union,5053,1012,182,38540.0,6247,0.8088682567632464,4041
Tennessee,Van Buren,1820,539,60,42813.0,2419,0.7523770152955767,1281
Tennessee,Warren,9540,3535,537,36245.0,13612,0.700852189244784,6005
Tennessee,Washington,34252,13024,2474,44444.0,49750,0.6884824120603015,21228
Tennessee,Wayne,5036,717,104,34008.0,5857,0.8598258494109613,4319
Tennessee,Weakley,9008,2772,404,38040.0,12184,0.7393302692055155,6236
Tennessee,White,7671,1845,309,35989.0,9825,0.7807633587786259,5826
Tennessee,Williamson,68212,31013,7046,100140.0,106271,0.6418684307101655,37199
Tennessee,Wilson,39406,14385,2943,63426.0,56734,0.6945746818486269,25021
Texas,Anderson,13201,3369,407,42146.0,16977,0.7775814337044237,9832
Texas,Andrews,3927,836,180,70121.0,4943,0.7944568076067166,3091
Texas,Angelina,21668,7538,705,44185.0,29911,0.7244157667747652,14130
Texas,Aransas,7740,2465,307,44851.0,10512,0.7363013698630136,5275
Texas,Archer,3786,394,103,62407.0,4283,0.8839598412327807,3392
Texas,Armstrong,924,70,27,65000.0,1021,0.9049951028403526,854
Texas,Atascosa,8618,4651,404,53181.0,13673,0.6302932787244935,3967
Texas,Austin,9637,2320,317,56681.0,12274,0.7851556134919342,7317
Texas,Bailey,1344,397,52,40589.0,1793,0.7495817066369214,947
Texas,Bandera,8163,1726,329,55434.0,10218,0.7988843217850852,6437
Texas,Bastrop,16328,10569,1557,55808.0,28454,0.5738384761369227,5759
Texas,Baylor,1267,191,41,34382.0,1499,0.8452301534356238,1076
Texas,Bee,4744,3444,297,44005.0,8485,0.559104301708898,1300
Texas,Bell,51998,37801,5195,51529.0,94994,0.5473819399119945,14197
Texas,Bexar,240333,319550,29762,52353.0,589645,0.4075893122132809,-79217
Texas,Blanco,4212,1244,229,56573.0,5685,0.7408970976253298,2968
Texas,Borden,330,31,4,77569.0,365,0.9041095890410958,299
Texas,Bosque,6339,1278,221,45419.0,7838,0.8087522327124267,5061
Texas,Bowie,24924,8838,840,42683.0,34602,0.7203051846714063,16086
Texas,Brazoria,72791,43200,5190,72006.0,121181,0.6006799745834743,29591
Texas,Brazos,38738,23121,5352,41654.0,67211,0.5763639880376724,15617
Texas,Brewster,2077,1873,302,38440.0,4252,0.48847601128880525,204
Texas,Briscoe,625,91,20,40385.0,736,0.8491847826086957,534
Texas,Brooks,613,1937,46,24913.0,2596,0.23613251155624038,-1324
Texas,Brown,12017,1621,388,43235.0,14026,0.8567660059888778,10396
Texas,Burleson,5316,1491,153,52513.0,6960,0.7637931034482759,3825
Texas,Burnet,14638,3797,769,54259.0,19204,0.7622370339512602,10841
Texas,Caldwell,6691,4795,606,49533.0,12092,0.5533410519351637,1896
Texas,Calhoun,4638,2118,209,54167.0,6965,0.6659009332376167,2520
Texas,Callahan,4865,569,145,40568.0,5579,0.8720200752823086,4296
Texas,Cameron,29472,59402,3205,34578.0,92079,0.32007298080995666,-29930
Texas,Camp,3201,1260,81,40045.0,4542,0.7047556142668429,1941
Texas,Carson,2620,249,95,64554.0,2964,0.8839406207827261,2371
Texas,Cass,9726,2391,227,39366.0,12344,0.7879131561892417,7335
Texas,Castro,1414,526,57,42733.0,1997,0.7080620931397096,888
Texas,Chambers,13339,2948,499,70396.0,16786,0.7946503038246158,10391
Texas,Cherokee,12919,3469,402,40769.0,16790,0.769446098868374,9450
Texas,Childress,1802,253,29,37125.0,2084,0.8646833013435701,1549
Texas,Clay,4377,536,105,45341.0,5018,0.8722598644878438,3841
Texas,Cochran,679,190,32,38625.0,901,0.753607103218646,489
Texas,Coke,1265,140,18,41756.0,1423,0.8889669711876318,1125
Texas,Coleman,3177,388,78,42049.0,3643,0.872083447707933,2789
Texas,Collin,201014,140624,19781,86188.0,361419,0.5561799462673518,60390
Texas,Collingsworth,983,145,28,40257.0,1156,0.8503460207612457,838
Texas,Colorado,6325,1987,201,45398.0,8513,0.7429813226829555,4338
Texas,Comal,45136,14238,2804,69666.0,62178,0.7259159188137283,30898
Texas,Comanche,4333,789,115,39054.0,5237,0.8273820889822417,3544
Texas,Concho,885,148,35,48516.0,1068,0.8286516853932584,737
Texas,Cooke,13181,2352,422,56269.0,15955,0.8261360075211532,10829
Texas,Coryell,12225,5064,964,49275.0,18253,0.6697529173286583,7161
Texas,Cottle,506,92,14,33750.0,612,0.826797385620915,414
Texas,Crane,1049,299,36,60133.0,1384,0.7579479768786127,750
Texas,Crockett,980,372,43,50646.0,1395,0.7025089605734767,608
Texas,Crosby,1181,468,79,39026.0,1728,0.6834490740740741,713
Texas,Culberson,280,454,33,33981.0,767,0.3650586701434159,-174
Texas,Dallam,1261,222,61,43897.0,1544,0.8167098445595855,1039
Texas,Dallas,262945,461080,34948,51411.0,758973,0.34644842438400314,-198135
Texas,Dawson,2636,835,92,42354.0,3563,0.7398259893348302,1801
Texas,Deaf Smith,2911,1185,120,47219.0,4216,0.6904648956356736,1726
Texas,Delta,1836,400,45,40529.0,2281,0.8049101271372205,1436
Texas,Denton,170603,110890,17152,76678.0,298645,0.5712568434093991,59713
Texas,Dewitt,5519,1163,162,50582.0,6844,0.8063997662185857,4356
Texas,Dickens,755,128,26,42118.0,909,0.8305830583058306,627
Texas,Dimmit,974,2173,78,32204.0,3225,0.302015503875969,-1199
Texas,Donley,1225,191,49,40560.0,1465,0.8361774744027304,1034
Texas,Duval,1316,2783,69,33115.0,4168,0.31573896353166986,-1467
Texas,Eastland,6011,776,176,34434.0,6963,0.8632773229929628,5235
Texas,Ector,25020,10249,1261,58335.0,36530,0.6849165069805639,14771
Texas,Edwards,746,303,24,39457.0,1073,0.6952469711090401,443
Texas,Ellis,44941,16253,2479,64382.0,63673,0.705809369748559,28688
Texas,El Paso,55512,147843,10653,42075.0,214008,0.2593921722552428,-92331
Texas,Erath,11210,2160,523,42492.0,13893,0.8068811631757,9050
Texas,Falls,3441,1684,123,38547.0,5248,0.6556783536585366,1757
Texas,Fannin,9548,2132,364,45471.0,12044,0.7927598804383925,7416
Texas,Fayette,8743,2144,287,51290.0,11174,0.7824413817791301,6599
Texas,Fisher,1265,403,61,41531.0,1729,0.7316367842683632,862
Texas,Floyd,1474,435,50,43070.0,1959,0.7524247064828994,1039
Texas,Foard,383,113,17,48068.0,513,0.746588693957115,270
Texas,Fort Bend,117291,134686,10089,91152.0,262066,0.44756282768462907,-17395
Texas,Franklin,3585,665,130,42652.0,4380,0.8184931506849316,2920
Texas,Freestone,6026,1471,187,45134.0,7684,0.7842269651223321,4555
Texas,Frio,1856,2444,100,37163.0,4400,0.4218181818181818,-588
Texas,Gaines,3907,597,116,58788.0,4620,0.8456709956709957,3310
Texas,Galveston,73757,43658,5488,63064.0,122903,0.6001236747679064,30099
Texas,Garza,1225,230,29,52708.0,1484,0.8254716981132075,995
Texas,Gillespie,10446,2288,480,55850.0,13214,0.7905252005448766,8158
Texas,Glasscock,553,34,17,62159.0,604,0.9155629139072847,519
Texas,Goliad,2620,973,115,54375.0,3708,0.7065803667745415,1647
Texas,Gonzales,4587,1571,176,46630.0,6334,0.7241869276918219,3016
Texas,Gray,6500,701,204,45264.0,7405,0.8777852802160703,5799
Texas,Grayson,35325,10301,1790,50212.0,47416,0.745001687194196,25024
Texas,Gregg,28764,11677,1308,47140.0,41749,0.688974586217634,17087
Texas,Grimes,7065,2194,274,47839.0,9533,0.7411098290150006,4871
Texas,Guadalupe,36632,18391,2799,64599.0,57822,0.633530490124866,18241
Texas,Hale,6366,2101,391,44995.0,8858,0.7186723865432377,4265
Texas,Hall,893,164,34,27244.0,1091,0.8185151237396884,729
Texas,Hamilton,3060,479,81,45105.0,3620,0.8453038674033149,2581
Texas,Hansford,1730,171,46,41335.0,1947,0.8885464817668207,1559
Texas,Hardeman,1207,249,57,35156.0,1513,0.797752808988764,958
Texas,Hardin,19606,2780,394,54352.0,22780,0.860667251975417,16826
Texas,Harris,545955,707914,58243,55584.0,1312112,0.4160887180362652,-161959
Texas,Harrison,18749,7151,648,46230.0,26548,0.7062302244990206,11598
Texas,Hartley,1730,173,49,64614.0,1952,0.8862704918032787,1557
Texas,Haskell,1403,314,53,41067.0,1770,0.7926553672316384,1089
Texas,Hays,33826,33224,5114,60495.0,72164,0.4687378748406408,602
Texas,Hemphill,1462,181,52,67773.0,1695,0.8625368731563422,1281
Texas,Henderson,23650,5669,726,43434.0,30045,0.7871526044266933,17981
Texas,Hidalgo,48642,118809,5986,36094.0,173437,0.28045918690936766,-70167
Texas,Hill,10108,2547,315,43441.0,12970,0.779336931380108,7561
Texas,Hockley,5809,1260,242,50331.0,7311,0.7945561482697305,4549
Texas,Hood,21382,4008,872,58315.0,26262,0.8141801842967025,17374
Texas,Hopkins,10707,2510,321,45748.0,13538,0.7908849165312454,8197
Texas,Houston,6205,1978,170,32434.0,8353,0.7428468813599904,4227
Texas,Howard,6637,1770,316,50977.0,8723,0.7608620887309412,4867
Texas,Hudspeth,503,324,44,26635.0,871,0.5774971297359357,179
Texas,Hunt,23910,6396,1248,45643.0,31554,0.7577486214109146,17514
Texas,Hutchinson,7042,854,259,50114.0,8155,0.863519313304721,6188
Texas,Irion,660,90,16,64100.0,766,0.8616187989556136,570
Texas,Jack,2973,314,63,50390.0,3350,0.8874626865671642,2659
Texas,Jackson,4266,904,132,56601.0,5302,0.8046020369671822,3362
Texas,Jasper,10609,2590,220,44552.0,13419,0.7905954243982413,8019
Texas,Jeff Davis,695,422,74,50174.0,1191,0.5835432409739715,273
Texas,Jefferson,42862,42443,2313,44965.0,87618,0.4891917185966354,419
Texas,Jim Hogg,430,1635,54,34769.0,2119,0.20292590844738084,-1205
Texas,Jim Wells,5420,6694,265,43321.0,12379,0.43783827449713225,-1274
Texas,Johnson,44382,10988,2236,59095.0,57606,0.7704405791063431,33394
Texas,Jones,4819,936,205,47007.0,5960,0.8085570469798657,3883
Texas,Karnes,2965,1145,88,46058.0,4198,0.7062887089090043,1820
Texas,Kaufman,29587,10278,1400,60179.0,41265,0.7169998788319399,19309
Texas,Kendall,15700,3643,777,76350.0,20120,0.7803180914512923,12057
Texas,Kenedy,84,99,3,24000.0,186,0.45161290322580644,-15
Texas,Kent,360,59,15,50625.0,434,0.8294930875576036,301
Texas,Kerr,17727,4681,889,44261.0,23297,0.7609134223290552,13046
Texas,Kimble,1697,206,49,41263.0,1952,0.8693647540983607,1491
Texas,King,149,5,5,57083.0,159,0.9371069182389937,144
Texas,Kinney,936,458,36,34398.0,1430,0.6545454545454545,478
Texas,Kleberg,4367,4716,429,41469.0,9512,0.45910428931875524,-349
Texas,Knox,1078,247,42,42188.0,1367,0.7885881492318947,831
Texas,Lamar,14561,3583,467,40283.0,18611,0.7823867605179733,10978
Texas,Lamb,3111,771,113,41401.0,3995,0.7787234042553192,2340
Texas,Lampasas,6385,1483,337,50358.0,8205,0.7781840341255332,4902
Texas,La Salle,872,1129,58,40094.0,2059,0.4235065565808645,-257
Texas,Lavaca,7347,1170,144,47753.0,8661,0.8482854173882923,6177
Texas,Lee,4997,1372,166,54346.0,6535,0.7646518745218056,3625
Texas,Leon,6391,909,139,47441.0,7439,0.859120849576556,5482
Texas,Liberty,18892,4862,513,49655.0,24267,0.7785057897556352,14030
Texas,Limestone,5796,1778,165,37431.0,7739,0.7489339707972607,4018
Texas,Lipscomb,1159,135,38,60163.0,1332,0.8701201201201201,1024
Texas,Live Oak,3464,742,96,50741.0,4302,0.805206880520688,2722
Texas,Llano,8299,1825,323,48562.0,10447,0.7943907341820619,6474
Texas,Loving,58,4,3,56875.0,65,0.8923076923076924,54
Texas,Lubbock,65651,28023,5339,46859.0,99013,0.6630543463989577,37628
Texas,Lynn,1546,403,60,40722.0,2009,0.7695370831259333,1143
Texas,McCulloch,2552,482,69,40784.0,3103,0.822429906542056,2070
Texas,McLennan,48260,27063,3752,44246.0,79075,0.610306670882074,21197
Texas,McMullen,454,40,5,57589.0,499,0.9098196392785571,414
Texas,Madison,3351,881,57,43209.0,4289,0.7813010025647004,2470
Texas,Marion,2983,1165,90,35424.0,4238,0.7038697498820198,1818
Texas,Martin,1455,266,41,63992.0,1762,0.825766174801362,1189
Texas,Mason,1656,354,47,38496.0,2057,0.8050559066601848,1302
Texas,Matagorda,8366,3500,330,41253.0,12196,0.6859626106920301,4866
Texas,Maverick,2816,10397,375,37155.0,13588,0.2072416838386812,-7581
Texas,Medina,12085,4634,527,58333.0,17246,0.7007422010901079,7451
Texas,Menard,682,154,28,37917.0,864,0.7893518518518519,528
Texas,Midland,36973,10025,2214,71424.0,49212,0.7513004958140291,26948
Texas,Milam,6364,2051,249,39213.0,8664,0.734533702677747,4313
Texas,Mills,1951,243,51,44375.0,2245,0.8690423162583519,1708
Texas,Mitchell,1780,354,62,51555.0,2196,0.8105646630236795,1426
Texas,Montague,7526,885,193,46383.0,8604,0.8747094374709438,6641
Texas,Montgomery,150314,45835,8483,70805.0,204632,0.7345576449431174,104479
Texas,Moore,3977,1098,209,50552.0,5284,0.7526495079485238,2879
Texas,Morris,3446,1425,102,37902.0,4973,0.6929418861854012,2021
Texas,Motley,566,40,9,35433.0,615,0.9203252032520325,526
Texas,Nacogdoches,14771,6846,1005,38915.0,22622,0.6529484572540005,7925
Texas,Navarro,11994,4002,437,43388.0,16433,0.7298728168928376,7992
Texas,Newton,4288,1156,90,36829.0,5534,0.7748464040477051,3132
Texas,Nolan,3552,1029,276,38411.0,4857,0.7313156269302038,2523
Texas,Nueces,50766,49198,4441,51882.0,104405,0.48624108040802644,1568
Texas,Ochiltree,2628,274,100,50011.0,3002,0.8754163890739507,2354
Texas,Oldham,850,78,20,52292.0,948,0.8966244725738397,772
Texas,Orange,25513,5735,752,51443.0,32000,0.79728125,19778
Texas,Palo Pinto,8284,1708,278,42824.0,10270,0.8066212268743914,6576
Texas,Panola,8445,1835,136,50712.0,10416,0.8107718894009217,6610
Texas,Parker,46473,8344,2000,67979.0,56817,0.8179418131897144,38129
Texas,Parmer,1915,485,66,48589.0,2466,0.7765612327656123,1430
Texas,Pecos,2468,1554,163,51735.0,4185,0.5897252090800478,914
Texas,Polk,15176,4187,489,40864.0,19852,0.764456981664316,10989
Texas,Potter,19630,7657,1364,40340.0,28651,0.6851418798645772,11973
Texas,Presidio,652,1458,98,33453.0,2208,0.29528985507246375,-806
Texas,Rains,3968,628,105,50405.0,4701,0.8440757285683897,3340
Texas,Randall,43462,8367,2476,62635.0,54305,0.8003314611914188,35095
Texas,Reagan,709,167,28,59257.0,904,0.7842920353982301,542
Texas,Real,1382,262,37,37059.0,1681,0.8221296847114813,1120
Texas,Red River,3926,1149,86,35016.0,5161,0.760705289672544,2777
Texas,Reeves,1417,1659,108,46464.0,3184,0.44503768844221103,-242
Texas,Refugio,1830,1034,84,50145.0,2948,0.6207598371777476,796
Texas,Roberts,524,20,10,72500.0,554,0.9458483754512635,504
Texas,Robertson,4668,2203,164,49142.0,7035,0.6635394456289979,2465
Texas,Rockwall,28451,9655,1842,89161.0,39948,0.7122008611194552,18796
Texas,Runnels,3250,453,79,41339.0,3782,0.8593336858804865,2797
Texas,Rusk,14675,3935,384,47424.0,18994,0.7726124039170265,10740
Texas,Sabine,3998,614,39,32500.0,4651,0.8596000860030101,3384
Texas,San Augustine,2622,910,37,29426.0,3569,0.7346595685065844,1712
Texas,San Jacinto,8059,2038,246,44878.0,10343,0.779174320796674,6021
Texas,San Patricio,13030,7871,755,52659.0,21656,0.6016808274843,5159
Texas,San Saba,2025,293,39,40718.0,2357,0.859142978362325,1732
Texas,Schleicher,821,208,30,59766.0,1059,0.7752596789423984,613
Texas,Scurry,4410,733,146,55661.0,5289,0.8338060124787294,3677
Texas,Shackelford,1378,103,23,50285.0,1504,0.9162234042553191,1275
Texas,Shelby,7179,1758,149,36312.0,9086,0.790116662998019,5421
Texas,Sherman,807,96,32,52969.0,935,0.8631016042780749,711
Texas,Smith,58930,22300,3538,48683.0,84768,0.6951915817289543,36630
Texas,Somervell,3206,541,150,50562.0,3897,0.8226841159866564,2665
Texas,Starr,2224,9289,227,26682.0,11740,0.18943781942078364,-7065
Texas,Stephens,3034,348,79,45217.0,3461,0.8766252528171049,2686
Texas,Sterling,549,70,14,50156.0,633,0.8672985781990521,479
Texas,Stonewall,555,135,11,47969.0,701,0.7917261055634808,420
Texas,Sutton,1075,313,28,54567.0,1416,0.759180790960452,762
Texas,Swisher,1671,462,71,35167.0,2204,0.7581669691470054,1209
Texas,Tarrant,345921,288392,34201,60373.0,668514,0.5174476525547708,57529
Texas,Taylor,33250,10085,2424,47044.0,45759,0.7266330120850543,23165
Texas,Terrell,288,140,10,24821.0,438,0.6575342465753424,148
Texas,Terry,2459,753,143,40407.0,3355,0.7329359165424739,1706
Texas,Throckmorton,715,84,9,39438.0,808,0.8849009900990099,631
Texas,Titus,6511,2597,311,45026.0,9419,0.6912623420745302,3914
Texas,Tom Green,27494,9173,1812,47637.0,38479,0.7145196080979236,18321
Texas,Travis,127209,308260,33251,64422.0,468720,0.2713965693804403,-181051
Texas,Trinity,4737,1154,94,35865.0,5985,0.7914786967418547,3583
Texas,Tyler,6624,1248,144,45427.0,8016,0.8263473053892215,5376
Texas,Upshur,13209,2380,424,47724.0,16013,0.8248922750265409,10829
Texas,Upton,1007,286,54,48220.0,1347,0.7475872308834447,721
Texas,Uvalde,4835,3867,262,39011.0,8964,0.5393797411869701,968
Texas,Val Verde,5890,6964,763,44170.0,13617,0.4325475508555482,-1074
Texas,Van Zandt,18473,2799,618,46555.0,21890,0.8439013248058475,15674
Texas,Victoria,21275,8866,982,54697.0,31123,0.6835780612408829,12409
Texas,Walker,12884,6091,821,40090.0,19796,0.6508385532430794,6793
Texas,Waller,10531,5748,505,53508.0,16784,0.6274428026692088,4783
Texas,Ward,2547,783,115,56796.0,3445,0.7393323657474601,1764
Texas,Washington,10945,3382,501,52718.0,14828,0.7381305637982196,7563
Texas,Webb,12947,42307,1651,38711.0,56905,0.22751955012740532,-29360
Texas,Wharton,10149,4238,345,46445.0,14732,0.6889084985066521,5911
Texas,Wheeler,2087,194,25,51082.0,2306,0.9050303555941024,1893
Texas,Wichita,27631,8770,1718,45371.0,38119,0.7248616175660432,18861
Texas,Wilbarger,3166,809,130,43635.0,4105,0.7712545676004872,2357
Texas,Willacy,1547,3422,126,28817.0,5095,0.30363101079489696,-1875
Texas,Williamson,104175,84468,14438,75935.0,203081,0.512972656230765,19707
Texas,Wilson,13998,4790,644,68737.0,19432,0.7203581720872787,9208
Texas,Winkler,1403,420,53,54261.0,1876,0.747867803837953,983
Texas,Wise,20670,3412,694,56396.0,24776,0.8342751049402648,17258
Texas,Wood,15700,2630,397,47814.0,18727,0.8383617237144231,13070
Texas,Yoakum,1797,426,80,56655.0,2303,0.7802865827181936,1371
Texas,Young,6601,876,230,46978.0,7707,0.8564940962761126,5725
Texas,Zapata,1029,2063,50,36976.0,3142,0.32749840865690644,-1034
Texas,Zavala,694,2636,66,26639.0,3396,0.2043580683156655,-1942
Utah,Beaver,1838,264,389,48083.0,2491,0.7378562826174228,1574
Utah,Box Elder,12230,2282,5223,55514.0,19735,0.6197111730428173,9948
Utah,Cache,21139,8563,16455,51935.0,46157,0.45798037134129166,12576
Utah,Carbon,5275,1717,960,47793.0,7952,0.6633551307847082,3558
Utah,Daggett,331,77,66,75938.0,474,0.6983122362869199,254
Utah,Davis,62219,28776,47416,72661.0,138411,0.44952352052943767,33443
Utah,Duchesne,5508,500,934,61244.0,6942,0.7934312878133103,5008
Utah,Emery,3425,380,484,51276.0,4289,0.7985544415947773,3045
Utah,Garfield,1606,358,380,45221.0,2344,0.6851535836177475,1248
Utah,Grand,1975,1960,598,43529.0,4533,0.4356938010147805,15
Utah,Iron,11561,2450,3643,43799.0,17654,0.6548657528038971,9111
Utah,Juab,2827,442,908,54861.0,4177,0.6768015322001436,2385
Utah,Kane,2265,741,499,50517.0,3505,0.6462196861626248,1524
Utah,Millard,3860,431,951,53902.0,5242,0.7363601678748569,3429
Utah,Morgan,3188,577,1427,80865.0,5192,0.6140215716486903,2611
Utah,Piute,626,47,56,37112.0,729,0.8587105624142661,579
Utah,Rich,797,104,208,52569.0,1109,0.7186654643823264,693
Utah,Salt Lake,138043,175863,104962,64601.0,418868,0.32956205773656616,-37820
Utah,San Juan,2645,2042,760,41108.0,5447,0.48558839728290804,603
Utah,Sanpete,6673,1061,2430,48866.0,10164,0.6565328610783157,5612
Utah,Sevier,6740,695,1219,48872.0,8654,0.7788305985671365,6045
Utah,Summit,7333,10503,2805,91470.0,20641,0.355263795358752,-3170
Utah,Tooele,11169,4573,6087,64149.0,21829,0.511658802510422,6596
Utah,Uintah,9810,995,1992,67943.0,12797,0.766585918574666,8815
Utah,Utah,102182,28522,70847,64321.0,201551,0.5069783826426066,73660
Utah,Wasatch,6115,3063,2942,71337.0,12120,0.5045379537953796,3052
Utah,Washington,42650,10288,9025,52865.0,61963,0.6883139938350306,32362
Utah,Wayne,966,271,184,41684.0,1421,0.6798029556650246,695
Utah,Weber,40235,23131,21673,59660.0,85039,0.47313585531344443,17104
Vermont,Addison,5297,11219,2515,61020.0,19031,0.27833534759077294,-5922
Vermont,Bennington,5925,9539,1917,51489.0,17381,0.34088947701513145,-3614
Vermont,Caledonia,5534,6445,2096,46931.0,14075,0.39317939609236235,-911
Vermont,Chittenden,18601,54814,10003,66414.0,83418,0.22298544678606536,-36213
Vermont,Essex,1506,1019,400,39467.0,2925,0.5148717948717949,487
Vermont,Franklin,8752,9351,3308,58884.0,21411,0.4087618513848022,-599
Vermont,Grand Isle,1487,2094,529,64295.0,4110,0.36180048661800485,-607
Vermont,Lamoille,3570,7241,1951,53316.0,12762,0.27973671838269865,-3671
Vermont,Orange,5007,7541,2101,54263.0,14649,0.3417980749539218,-2534
Vermont,Orleans,5159,5185,1703,43959.0,12047,0.42823939570017433,-26
Vermont,Rutland,12479,13635,3505,50029.0,29619,0.42131739761639486,-1156
Vermont,Washington,7993,18594,4499,58171.0,31086,0.2571253940680692,-10601
Vermont,Windham,5454,14340,2841,50917.0,22635,0.24095427435387673,-8886
Vermont,Windsor,8605,17556,3767,54763.0,29928,0.28752338946805667,-8951
Virginia,Accomack,8583,6740,495,38503.0,15818,0.542609685168795,1843
Virginia,Albemarle,19259,33345,4122,70342.0,56726,0.3395092197581356,-14086
Virginia,Alleghany,4874,2166,285,45538.0,7325,0.6653924914675768,2708
Virginia,Amelia,4708,2128,204,58269.0,7040,0.66875,2580
Virginia,Amherst,9719,5057,620,47002.0,15396,0.6312678617822811,4662
Virginia,Appomattox,5715,2023,273,52134.0,8011,0.7133940831356884,3692
Virginia,Arlington,20186,92016,9154,108706.0,121356,0.16633705791225814,-71830
Virginia,Augusta,26163,8177,2003,56802.0,36343,0.7198910381641581,17986
Virginia,Bath,1548,603,102,44985.0,2253,0.6870838881491345,945
Virginia,Bedford,30659,9768,2098,56725.0,42525,0.7209641387419166,20891
Virginia,Bland,2573,453,113,47800.0,3139,0.8196877986619943,2120
Virginia,Botetourt,13375,4494,870,61470.0,18739,0.7137520678798228,8881
Virginia,Brunswick,3046,4481,142,38858.0,7669,0.3971834659016821,-1435
Virginia,Buchanan,7296,1721,230,30335.0,9247,0.789012652752244,5575
Virginia,Buckingham,3950,3128,217,43514.0,7295,0.5414667580534612,822
Virginia,Campbell,19551,6664,1320,47005.0,27535,0.7100417650263301,12887
Virginia,Caroline,7147,6432,1284,57294.0,14863,0.48085850770369376,715
Virginia,Carroll,10663,2559,446,37048.0,13668,0.7801434006438396,8104
Virginia,Charles City,1476,2496,135,54167.0,4107,0.3593864134404675,-1020
Virginia,Charlotte,3479,2155,174,33837.0,5808,0.5990013774104683,1324
Virginia,Chesterfield,85045,81074,10342,73869.0,176461,0.48194785249998584,3971
Virginia,Clarke,4661,3051,501,71986.0,8213,0.5675149153780592,1610
Virginia,Craig,2140,541,113,40500.0,2794,0.7659269863994274,1599
Virginia,Culpeper,13349,7759,1110,66160.0,22218,0.6008191556395716,5590
Virginia,Cumberland,2697,2036,173,37489.0,4906,0.5497350183448838,661
Virginia,Dickenson,4932,1335,173,31226.0,6440,0.7658385093167702,3597
Virginia,Dinwiddie,7447,5765,363,51579.0,13575,0.5485819521178638,1682
Virginia,Essex,2657,2542,209,47527.0,5408,0.49130917159763315,115
Virginia,Fairfax,157710,355133,38340,114329.0,551183,0.28613001489523443,-197423
Virginia,Fauquier,22127,12971,2369,91221.0,37467,0.590573037606427,9156
Virginia,Floyd,5293,2300,458,47288.0,8051,0.657433859147932,2993
Virginia,Fluvanna,7025,5760,812,66425.0,13597,0.5166580863425756,1265
Virginia,Franklin,18569,7257,1145,48720.0,26971,0.6884802194950131,11312
Virginia,Frederick,26083,11932,2425,68929.0,40440,0.6449802176063304,14151
Virginia,Giles,5910,1950,352,47675.0,8212,0.7196785192401364,3960
Virginia,Gloucester,13096,5404,1119,62878.0,19619,0.667516183291707,7692
Virginia,Goochland,8384,4889,764,82326.0,14037,0.5972786207879176,3495
Virginia,Grayson,5592,1407,286,31002.0,7285,0.7676046671242278,4185
Virginia,Greene,5945,2924,739,61615.0,9608,0.6187552039966694,3021
Virginia,Greensville,1737,2558,68,40559.0,4363,0.3981205592482237,-821
Virginia,Halifax,9704,6897,400,37001.0,17001,0.5707899535321451,2807
Virginia,Hanover,39630,19382,3741,81170.0,62753,0.6315235924975698,20248
Virginia,Henrico,59857,93935,9862,63699.0,163654,0.3657533576936708,-34078
Virginia,Henry,15208,8198,700,34992.0,24106,0.6308802787687713,7010
Virginia,Highland,958,371,62,44877.0,1391,0.6887131560028756,587
Virginia,Isle of Wight,12204,7881,990,66835.0,21075,0.5790747330960854,4323
Virginia,James City,21306,19105,2762,80226.0,43173,0.4935028837467862,2201
Virginia,King and Queen,2099,1468,130,48852.0,3697,0.5677576413308087,631
Virginia,King George,7341,4007,711,84342.0,12059,0.6087569450203167,3334
Virginia,King William,5975,2760,426,64297.0,9161,0.6522213732125314,3215
Virginia,Lancaster,3523,2869,253,50118.0,6645,0.5301730624529721,654
Virginia,Lee,7543,1627,229,31577.0,9399,0.8025321842749229,5916
Virginia,Loudoun,69949,100795,12353,125672.0,183097,0.3820324745899714,-30846
Virginia,Louisa,10528,6212,891,54662.0,17631,0.5971300550167319,4316
Virginia,Lunenburg,3204,2227,155,39911.0,5586,0.5735767991407089,977
Virginia,Madison,4419,2203,357,48271.0,6979,0.6331852700960023,2216
Virginia,Mathews,3517,1563,231,64049.0,5311,0.6622105064959518,1954
Virginia,Mecklenburg,8288,6285,372,40040.0,14945,0.5545667447306791,2003
Virginia,Middlesex,3670,2108,239,53093.0,6017,0.6099385075619079,1562
Virginia,Montgomery,19459,20021,3551,49712.0,43031,0.4522088726731891,-562
Virginia,Nelson,4154,3689,475,50994.0,8318,0.4993988939648954,465
Virginia,New Kent,8118,3546,578,75303.0,12242,0.6631269400424767,4572
Virginia,Northampton,2686,3255,231,37011.0,6172,0.4351911860012962,-569
Virginia,Northumberland,4302,2852,244,54440.0,7398,0.5815085158150851,1450
Virginia,Nottoway,3712,2829,203,36849.0,6744,0.5504151838671412,883
Virginia,Orange,10521,5957,792,66990.0,17270,0.6092067168500289,4564
Virginia,Page,7831,2514,395,45030.0,10740,0.7291433891992551,5317
Virginia,Patrick,6454,1768,303,35999.0,8525,0.7570674486803519,4686
Virginia,Pittsylvania,21554,9199,845,43087.0,31598,0.6821317804924363,12355
Virginia,Powhatan,11885,4060,955,77684.0,16900,0.7032544378698224,7825
Virginia,Prince Edward,4101,4591,451,42283.0,9143,0.44853986656458494,-490
Virginia,Prince George,9157,6419,608,64805.0,16184,0.5658057340583292,2738
Virginia,Prince William,71721,113144,11673,98546.0,196538,0.36492179629384647,-41423
Virginia,Pulaski,10322,4172,673,49469.0,15167,0.6805564712863453,6150
Virginia,Rappahannock,2539,1747,197,58026.0,4483,0.5663618112870845,792
Virginia,Richmond,2213,1347,101,44919.0,3661,0.6044796503687517,866
Virginia,Roanoke,31408,17200,2881,60380.0,51489,0.6099943677290295,14208
Virginia,Rockbridge,6680,3508,607,52478.0,10795,0.618805002315887,3172
Virginia,Rockingham,25990,9366,2131,55029.0,37487,0.6933070130978739,16624
Virginia,Russell,9521,2330,395,38370.0,12246,0.777478360280908,7191
Virginia,Scott,8247,1581,272,38017.0,10100,0.8165346534653465,6666
Virginia,Shenandoah,14094,5273,1146,50450.0,20513,0.6870764880807293,8821
Virginia,Smyth,9750,2665,475,38906.0,12890,0.756400310318076,7085
Virginia,Southampton,5035,3595,248,51032.0,8878,0.5671322369903131,1440
Virginia,Spotsylvania,34623,24207,3732,79742.0,62562,0.553419008343723,10416
Virginia,Stafford,33868,27908,4158,97528.0,65934,0.513665180331847,5960
Virginia,Surry,1819,2272,137,56632.0,4228,0.4302270577105014,-453
Virginia,Sussex,2055,2879,110,37917.0,5044,0.40741475019825535,-824
Virginia,Tazewell,15168,2895,503,38238.0,18566,0.8169772702790047,12273
Virginia,Warren,11773,5169,1018,63734.0,17960,0.6555122494432071,6604
Virginia,Washington,19320,5553,974,43835.0,25847,0.747475529074941,13767
Virginia,Westmoreland,4448,3836,290,51566.0,8574,0.5187777000233263,612
Virginia,Wise,12086,2701,376,36352.0,15163,0.7970718195607729,9385
Virginia,Wythe,10046,2770,527,42888.0,13343,0.7529041444952409,7276
Virginia,York,18837,12999,2282,83410.0,34118,0.5521132540008207,5838
Virginia,Alexandria,13285,57242,5243,89200.0,75770,0.17533324534776296,-43957
Virginia,Bedford,30659,9768,2098,56725,42525,0.720964,20891
Virginia,Bristol,4892,1835,305,35801.0,7032,0.6956769055745164,3057
Virginia,Buena Vista,1430,693,284,29109.0,2407,0.5941005400914001,737
Virginia,Charlottesville,2960,17901,1611,50727.0,22472,0.13171947312210752,-14941
Virginia,Chesapeake,54047,52627,6031,69978.0,112705,0.47954394214986024,1420
Virginia,Colonial Heights,5681,2367,409,49639.0,8457,0.6717512120137165,3314
Virginia,Covington,1349,914,119,34703.0,2382,0.5663308144416457,435
Virginia,Danville,7303,11059,590,33721.0,18952,0.3853419164204306,-3756
Virginia,Emporia,789,1530,48,27169.0,2367,0.3333333333333333,-741
Virginia,Fairfax,3702,7367,961,104065.0,12030,0.3077306733167082,-3665
Virginia,Falls Church,1324,5819,614,115244.0,7757,0.17068454299342528,-4495
Virginia,Franklin,1421,2519,130,38333.0,4070,0.34914004914004915,-1098
Virginia,Fredericksburg,3744,6707,813,53980.0,11264,0.33238636363636365,-2963
Virginia,Galax,1603,681,92,31110.0,2376,0.6746632996632996,922
Virginia,Hampton,17902,41312,3142,49890.0,62356,0.2870934633395343,-23410
Virginia,Harrisonburg,6262,10212,1519,40494.0,17993,0.34802423164563995,-3950
Virginia,Hopewell,3885,4724,399,40814.0,9008,0.4312833037300178,-839
Virginia,Lexington,766,1514,185,34464.0,2465,0.3107505070993915,-748
Virginia,Lynchburg,17982,14792,2897,40728.0,35671,0.5041069776569201,3190
Virginia,Manassas,5953,8423,1035,74371.0,15411,0.38628252546882097,-2470
Virginia,Manassas Park,1733,3204,295,75027.0,5232,0.3312308868501529,-1471
Virginia,Martinsville,2149,3533,225,31719.0,5907,0.3638056543084476,-1384
Virginia,Newport News,25468,45618,4629,50089.0,75715,0.3363666380505844,-20150
Virginia,Norfolk,21552,57023,4813,45268.0,83388,0.2584544538782559,-35471
Virginia,Norton,1021,383,56,26000.0,1460,0.6993150684931507,638
Virginia,Petersburg,1451,12021,314,32169.0,13786,0.10525170462788336,-10570
Virginia,Poquoson,5092,1601,484,84643.0,7177,0.70948864428034,3491
Virginia,Portsmouth,12795,28497,1973,47050.0,43265,0.29573558303478564,-15702
Virginia,Radford,2638,2925,522,31457.0,6085,0.43352506162695154,-287
Virginia,Richmond,15581,81259,6644,41187.0,103484,0.1505643384484558,-65678
Virginia,Roanoke,14789,22286,2391,39201.0,39466,0.3747276136421223,-7497
Virginia,Salem,7226,4202,797,52351.0,12225,0.5910838445807771,3024
Virginia,Staunton,5133,5333,789,42948.0,11255,0.4560639715681919,-200
Virginia,Suffolk,18006,23280,1954,65435.0,43240,0.41641998149861237,-5274
Virginia,Virginia Beach,98224,91032,14006,67719.0,203262,0.4832383819897472,7192
Virginia,Waynesboro,4801,3764,639,45097.0,9204,0.5216210343328987,1037
Virginia,Williamsburg,1925,5206,495,50091.0,7626,0.25242591135588777,-3281
Virginia,Winchester,4790,5164,713,46466.0,10667,0.4490484672353989,-374
Washington,Adams,3083,1299,262,47554.0,4644,0.6638673557278209,1784
Washington,Asotin,5741,3134,861,45550.0,9736,0.5896672144617913,2607
Washington,Benton,47194,26360,6473,61147.0,80027,0.5897259674859735,20834
Washington,Chelan,18114,13032,2234,51845.0,33380,0.5426602756141402,5082
Washington,Clallam,18794,17677,2986,47180.0,39457,0.47631598955825327,1117
Washington,Clark,92441,92757,14962,62879.0,200160,0.4618355315747402,-316
Washington,Columbia,1497,526,159,42083.0,2182,0.6860678276810266,971
Washington,Cowlitz,24185,17908,3599,49127.0,45692,0.5293049111441828,6277
Washington,Douglas,9603,4918,1022,53758.0,15543,0.6178343949044586,4685
Washington,Ferry,2202,1098,301,39555.0,3601,0.6114968064426548,1104
Washington,Franklin,13206,8886,1628,58284.0,23720,0.5567453625632378,4320
Washington,Garfield,851,279,116,51395.0,1246,0.6829855537720706,572
Washington,Grant,18518,7810,2018,50145.0,28346,0.6532844140266705,10708
Washington,Grays Harbor,14067,12020,2280,44521.0,28367,0.4958931152395389,2047
Washington,Island,18465,20960,3451,60261.0,42876,0.43066050937587463,-2495
Washington,Jefferson,6037,12656,1583,50928.0,20276,0.2977411718287631,-6619
Washington,King,216339,718322,63838,78800.0,998499,0.21666421298368851,-501983
Washington,Kitsap,49018,63156,12143,65017.0,124317,0.394298446712839,-14138
Washington,Kittitas,10100,7489,1366,47898.0,18955,0.5328409390662094,2611
Washington,Klickitat,5789,4194,786,49633.0,10769,0.537561519175411,1595
Washington,Lewis,21992,9654,2503,44526.0,34149,0.6440012884711119,12338
Washington,Lincoln,4108,1244,361,47676.0,5713,0.719061788902503,2864
Washington,Mason,13677,11993,2403,51764.0,28073,0.48719410109357747,1684
Washington,Okanogan,9610,6298,1183,41158.0,17091,0.5622842431689193,3312
Washington,Pacific,5360,4620,736,38387.0,10716,0.5001866368047779,740
Washington,Pend Oreille,4373,1934,495,46036.0,6802,0.6428991473096148,2439
Washington,Pierce,146824,172538,29123,61468.0,348485,0.42132086029527815,-25714
Washington,San Juan,2688,7172,914,58029.0,10774,0.2494895117876369,-4484
Washington,Skagit,24736,26690,4542,56433.0,55968,0.4419668381932533,-1954
Washington,Skamania,2928,2232,479,53082.0,5639,0.5192410001773364,696
Washington,Snohomish,128255,185227,28691,73528.0,342173,0.37482501541617835,-56972
Washington,Spokane,113435,93767,20044,50550.0,227246,0.49917270270983866,19668
Washington,Stevens,15161,5767,1749,44115.0,22677,0.6685628610486396,9394
Washington,Thurston,48624,68798,11988,62854.0,129410,0.3757360327640831,-20174
Washington,Wahkiakum,1344,832,182,48116.0,2358,0.5699745547073791,512
Washington,Walla Walla,13651,9694,2074,48705.0,25419,0.5370392226287423,3957
Washington,Whatcom,40599,60340,8734,54207.0,109673,0.3701822691090788,-19741
Washington,Whitman,7403,8146,1756,38636.0,17305,0.4277954348454204,-743
Washington,Yakima,41735,31291,4724,45700.0,77750,0.5367845659163987,10444
West Virginia,Barbour,4527,1222,305,36733.0,6054,0.7477700693756194,3305
West Virginia,Berkeley,28244,12321,2285,57148.0,42850,0.6591365227537923,15923
West Virginia,Boone,6504,1790,389,37820.0,8683,0.7490498675572959,4714
West Virginia,Braxton,3537,1321,232,38092.0,5090,0.6948919449901768,2216
West Virginia,Brooke,6625,2568,420,46265.0,9613,0.6891709143867679,4057
West Virginia,Cabell,19850,11447,1788,37760.0,33085,0.5999697748224271,8403
West Virginia,Calhoun,2035,456,126,39384.0,2617,0.7776079480320979,1579
West Virginia,Clay,2300,568,104,33639.0,2972,0.7738896366083445,1732
West Virginia,Doddridge,2358,362,120,39381.0,2840,0.8302816901408451,1996
West Virginia,Fayette,10357,4290,690,37846.0,15337,0.6752950381430527,6067
West Virginia,Gilmer,1896,545,102,37286.0,2543,0.7455760912308297,1351
West Virginia,Grant,4346,512,98,38703.0,4956,0.8769168684422922,3834
West Virginia,Greenbrier,9556,3765,745,40026.0,14066,0.6793686904592635,5791
West Virginia,Hampshire,6692,1580,336,32177.0,8608,0.7774163568773235,5112
West Virginia,Hancock,8909,3262,531,40316.0,12702,0.7013856085655802,5647
West Virginia,Hardy,4274,1155,214,39840.0,5643,0.7573985468722311,3119
West Virginia,Harrison,18750,7694,1516,44845.0,27960,0.6706008583690987,11056
West Virginia,Jackson,9020,2663,504,40949.0,12187,0.7401329285304012,6357
West Virginia,Jefferson,13204,9518,1425,69753.0,24147,0.5468174100302315,3686
West Virginia,Kanawha,43850,28263,3577,46528.0,75690,0.5793367683974104,15587
West Virginia,Lewis,5274,1347,307,37827.0,6928,0.7612586605080831,3927
West Virginia,Lincoln,5307,1459,300,36232.0,7066,0.751061420888763,3848
West Virginia,Logan,9897,2092,370,37262.0,12359,0.8007929444129784,7805
West Virginia,McDowell,4629,1438,136,25206.0,6203,0.746251813638562,3191
West Virginia,Marion,14668,6964,1397,46430.0,23029,0.6369360371705242,7704
West Virginia,Marshall,9666,2918,632,44464.0,13216,0.7313861985472155,6748
West Virginia,Mason,7654,2081,451,37322.0,10186,0.7514235224818379,5573
West Virginia,Mercer,17404,4704,874,37255.0,22982,0.7572883125924637,12700
West Virginia,Mineral,9070,2050,444,36153.0,11564,0.7843306814251124,7020
West Virginia,Mingo,7911,1370,229,32441.0,9510,0.8318611987381703,6541
West Virginia,Monongalia,18432,14699,2917,47060.0,36048,0.511318242343542,3733
West Virginia,Monroe,4443,1111,251,35995.0,5805,0.765374677002584,3332
West Virginia,Morgan,5732,1573,349,43234.0,7654,0.7488894695584009,4159
West Virginia,Nicholas,7251,1840,400,39901.0,9491,0.7639869349910442,5411
West Virginia,Ohio,11139,5493,1306,41986.0,17938,0.6209722377076597,5646
West Virginia,Pendleton,2398,729,98,37035.0,3225,0.7435658914728682,1669
West Virginia,Pleasants,2358,621,171,45191.0,3150,0.7485714285714286,1737
West Virginia,Pocahontas,2496,928,222,36026.0,3646,0.6845858475041141,1568
West Virginia,Preston,9538,2470,651,45221.0,12659,0.75345603918161,7068
West Virginia,Putnam,17788,5884,1221,56640.0,24893,0.7145783955328807,11904
West Virginia,Raleigh,22048,6443,1127,41533.0,29618,0.7444121817813492,15605
West Virginia,Randolph,7629,2735,512,40308.0,10876,0.7014527399779331,4894
West Virginia,Ritchie,3405,496,174,40850.0,4075,0.8355828220858895,2909
West Virginia,Roane,3781,1222,244,34144.0,5247,0.7206022489041357,2559
West Virginia,Summers,3455,1190,217,35620.0,4862,0.7106129164952695,2265
West Virginia,Taylor,4733,1491,314,44371.0,6538,0.7239216885897828,3242
West Virginia,Tucker,2565,751,159,43529.0,3475,0.7381294964028777,1814
West Virginia,Tyler,2996,507,151,38674.0,3654,0.8199233716475096,2489
West Virginia,Upshur,7005,1766,447,42240.0,9218,0.7599262312866132,5239
West Virginia,Wayne,11152,3357,673,38311.0,15182,0.7345540771966803,7795
West Virginia,Webster,2302,556,120,29982.0,2978,0.7730020147750168,1746
West Virginia,Wetzel,4519,1359,387,39446.0,6265,0.7213088587390263,3160
West Virginia,Wirt,1911,386,125,38101.0,2422,0.7890173410404624,1525
West Virginia,Wood,25434,8400,1781,43944.0,35615,0.7141373016987225,17034
West Virginia,Wyoming,6547,1062,222,35469.0,7831,0.8360362661218235,5485
Wisconsin,Adams,5983,3770,411,43554.0,10164,0.5886462022825659,2213
Wisconsin,Ashland,3302,4228,499,40297.0,8029,0.4112591854527338,-926
Wisconsin,Barron,13606,7879,1158,46863.0,22643,0.6008921079362275,5727
Wisconsin,Bayfield,4125,4954,450,48132.0,9529,0.4328890754538776,-829
Wisconsin,Brown,67199,53364,8416,54172.0,128979,0.5210072957613255,13835
Wisconsin,Buffalo,4049,2531,408,52447.0,6988,0.5794218660560961,1518
Wisconsin,Burnett,5412,2948,383,42441.0,8743,0.6190094933089328,2464
Wisconsin,Calumet,15348,9646,1656,70042.0,26650,0.5759099437148217,5702
Wisconsin,Chippewa,17909,11886,1766,52657.0,31561,0.567440828871075,6023
Wisconsin,Clark,8646,4227,723,46783.0,13596,0.6359223300970874,4419
Wisconsin,Columbia,14160,13526,2085,61004.0,29771,0.475630647274193,634
Wisconsin,Crawford,3844,3425,475,45780.0,7744,0.49638429752066116,419
Wisconsin,Dane,71279,217526,21212,64773.0,310017,0.22991964956760436,-146247
Wisconsin,Dodge,26643,13968,2454,54111.0,43065,0.6186694531522118,12675
Wisconsin,Door,8584,8026,998,53980.0,17608,0.48750567923671057,558
Wisconsin,Douglas,9659,11345,1507,48190.0,22511,0.4290791168761939,-1686
Wisconsin,Dunn,11488,9026,1577,51787.0,22091,0.5200307817663302,2462
Wisconsin,Eau Claire,23311,27294,4280,50538.0,54885,0.42472442379520814,-3983
Wisconsin,Florence,1897,666,94,46595.0,2657,0.713963116296575,1231
Wisconsin,Fond du Lac,31044,17391,2892,56376.0,51327,0.6048278683733708,13653
Wisconsin,Forest,2788,1584,168,41378.0,4540,0.6140969162995594,1204
Wisconsin,Grant,12349,10046,1926,49077.0,24321,0.5077505036799473,2303
Wisconsin,Green,8693,9122,1170,57416.0,18985,0.4578878061627601,-429
Wisconsin,Green Lake,6213,2701,474,47174.0,9388,0.661802300809544,3512
Wisconsin,Iowa,4809,6669,782,56641.0,12260,0.39225122349102776,-1860
Wisconsin,Iron,2090,1273,134,41270.0,3497,0.597655132971118,817
Wisconsin,Jackson,4907,3821,544,49608.0,9272,0.5292277825711821,1086
Wisconsin,Jefferson,23410,16561,3175,57290.0,43146,0.5425763686089092,6849
Wisconsin,Juneau,7123,4073,536,47243.0,11732,0.6071428571428571,3050
Wisconsin,Kenosha,36025,35771,5280,56086.0,77076,0.46739581711557426,254
Wisconsin,Kewaunee,6616,3623,519,58152.0,10758,0.6149841978062837,2993
Wisconsin,La Crosse,26389,32406,4173,51477.0,62968,0.41908588489391435,-6017
Wisconsin,Lafayette,3977,3288,397,53038.0,7662,0.5190550770033934,689
Wisconsin,Langlade,6436,3260,436,43501.0,10132,0.6352151598894591,3176
Wisconsin,Lincoln,8400,5370,936,52221.0,14706,0.5711954304365565,3030
Wisconsin,Manitowoc,23193,14506,2647,49613.0,40346,0.5748525256531006,8687
Wisconsin,Marathon,39013,26477,4025,54227.0,69515,0.5612170035244192,12536
Wisconsin,Marinette,12995,6243,808,43893.0,20046,0.6482590042901327,6752
Wisconsin,Marquette,4714,2809,370,48445.0,7893,0.5972380590396554,1905
Wisconsin,Menominee,269,1003,7,37147.0,1279,0.21032056293979673,-734
Wisconsin,Milwaukee,125846,288797,25604,45263.0,440247,0.2858531687893387,-162951
Wisconsin,Monroe,11352,7048,1270,53394.0,19670,0.5771225216065073,4304
Wisconsin,Oconto,13253,5884,841,54018.0,19978,0.6633797176894584,7369
Wisconsin,Oneida,12117,8104,1252,49715.0,21473,0.5642900386531924,4013
Wisconsin,Outagamie,49884,38087,5897,59806.0,93868,0.5314271104103635,11797
Wisconsin,Ozaukee,30430,20168,3925,78415.0,54523,0.5581130898886708,10262
Wisconsin,Pepin,2206,1345,188,51346.0,3739,0.5899973254880985,861
Wisconsin,Pierce,11258,8382,1549,64364.0,21189,0.5313134173391855,2876
Wisconsin,Polk,13815,7570,1364,52039.0,22749,0.6072794408545431,6245
Wisconsin,Portage,17306,18521,2669,52411.0,38496,0.44955320033250207,-1215
Wisconsin,Price,4562,2669,346,43547.0,7577,0.6020852580176851,1893
Wisconsin,Racine,46611,42512,5010,56359.0,94133,0.49516110184526146,4099
Wisconsin,Richland,4023,3577,455,46564.0,8055,0.4994413407821229,446
Wisconsin,Rock,31488,39343,5237,50968.0,76068,0.41394541725824263,-7855
Wisconsin,Rusk,4564,2171,352,39904.0,7087,0.6439960491039932,2393
Wisconsin,St. Croix,26220,17486,3802,73743.0,47508,0.5519070472341501,8734
Wisconsin,Sauk,14791,14692,1835,53225.0,31318,0.4722843093428699,99
Wisconsin,Sawyer,5185,3504,432,41869.0,9121,0.5684683696963052,1681
Wisconsin,Shawano,12742,6056,953,48773.0,19751,0.6451318920560984,6686
Wisconsin,Sheboygan,32458,22956,4241,54392.0,59655,0.5440952141480178,9502
Wisconsin,Taylor,6589,2398,497,47306.0,9484,0.6947490510333193,4191
Wisconsin,Trempealeau,7364,5636,675,52438.0,13675,0.5385009140767825,1728
Wisconsin,Vernon,6996,6352,865,49476.0,14213,0.4922254274255963,644
Wisconsin,Vilas,8169,4770,673,41632.0,13612,0.6001322362621216,3399
Wisconsin,Walworth,28851,18706,3767,55575.0,51324,0.5621346738368015,10145
Wisconsin,Washburn,5404,3284,460,44437.0,9148,0.5907302142544818,2120
Wisconsin,Washington,51729,20855,5419,70325.0,78003,0.663166801276874,30874
Wisconsin,Waukesha,142521,79200,17321,78268.0,239042,0.596217401126162,63321
Wisconsin,Waupaca,16189,8440,1395,52441.0,26024,0.622079618813403,7749
Wisconsin,Waushara,7669,3792,538,46581.0,11999,0.6391365947162263,3877
Wisconsin,Winnebago,43448,37054,6642,53501.0,87144,0.4985770678417332,6394
Wisconsin,Wood,21503,14232,2065,49926.0,37800,0.5688624338624338,7271
Wyoming,Albany,7602,6890,2568,43043.0,17060,0.4456037514654162,712
Wyoming,Big Horn,4067,604,646,50820.0,5317,0.764905021628738,3463
Wyoming,Campbell,15778,1324,1097,80822.0,18199,0.8669707126765207,14454
Wyoming,Carbon,4409,1279,686,56972.0,6374,0.6917163476623784,3130
Wyoming,Converse,5520,668,466,66737.0,6654,0.8295761947700632,4852
Wyoming,Crook,3348,273,205,60307.0,3826,0.8750653423941454,3075
Wyoming,Fremont,11167,4200,1656,53559.0,17023,0.6559948305234095,6967
Wyoming,Goshen,4418,924,454,44883.0,5796,0.7622498274672188,3494
Wyoming,Hot Springs,1939,400,247,46087.0,2586,0.7498066511987626,1539
Wyoming,Johnson,3477,638,302,54594.0,4417,0.7871858727643197,2839
Wyoming,Laramie,24847,11573,4549,61201.0,40969,0.6064829505235666,13274
Wyoming,Lincoln,6779,1105,991,64579.0,8875,0.7638309859154929,5674
Wyoming,Natrona,23552,6577,3219,56983.0,33348,0.7062492503298549,16975
Wyoming,Niobrara,1116,115,83,40640.0,1314,0.8493150684931506,1001
Wyoming,Park,11115,2535,1445,61185.0,15095,0.7363365352765816,8580
Wyoming,Platte,3437,719,373,41051.0,4529,0.758887171561051,2718
Wyoming,Sheridan,10266,2927,1317,53914.0,14510,0.7075120606478291,7339
Wyoming,Sublette,3409,644,337,76004.0,4390,0.7765375854214123,2765
Wyoming,Sweetwater,12154,3231,1745,68233.0,17130,0.7095154699357852,8923
Wyoming,Teton,3921,7314,1392,75594.0,12627,0.31052506533618435,-3393
Wyoming,Uinta,6154,1202,1114,53323.0,8470,0.7265643447461629,4952
Wyoming,Washakie,2911,532,371,46212.0,3814,0.7632406921866807,2379
Wyoming,Weston,3033,299,194,55640.0,3526,0.8601815087918321,2734
